predicted_glosses	glosses
« ZUN », lag'ana , « fena insanjerin araDA g'atDA , akvan belke zi k'ismetDA ava .»	« 1sg.abs », say-AOR , « go-AOR man-ERG-GEN between-INESS enter.FUT-FUT , look.HORT maybe 1sg.gen fate-INESS cop .»
agreement one be.3SG	agreement-PL one was .
« And.but 1pl.abs they-ERG-GEN to return-AOR need-ENT , come group happen-AOR go.back.HORT 1pl.abs .»	« And.but 1pl.abs them-ERG-GEN to returned-AOR want-ENT , come group happened-AOR go.back.HORT 1pl.abs .»
what be-N love be-SG , ashuq boy	love what was , ashuq boy ?
why where be-AOR ?	what-DAT , where be-AOR ?
many good toast-PL-ERG say-AOR , each-ABS person-PL-ERG happy-AOR event-ABS about .	good toasts-PL say-AOR , agreements-PL be-AOR , 1pl.abs event.from-OBL-SUPER-EL agree remain-AOR .
well Chukotka cold place be.3sg-PST-PFO , very cold be.1sg.abs-PST-PFO , .	well Chukotka cold place was , cold place was .
Natavan	( Natavan ).
they-ERG « call.IMPV that boy » say-ENT , « they you-DAT take.IMPV » say-ENT , « they he-DAT worthy not-be.PRS ».	they-ERG « call.IMPV that boy » say-ENT , « they 2sg-DAT take.IMPV » say-ENT , « they he-DAT worthy cop.NEG ».
then this boy-ERG say-ENT that, « but now all happen-PERF », say-ENT, « grandfather-DIR punishment take-AOR, other-PL-ERG punishment take-AOR, but, » say-AOR, « other province-INESS 1sg-GEN mother-FOC exist-PRS », say-AOR, « three brother-FOC exist-PRS, two brother-FOC exist-PRS » say-AOR.	then this boy-ERG say-ENT that , « but now all happened-PERF », say-ENT , « grandfather-DIR-FOC punishment take-AOR , others.and-ERG-FOC punishment take-AOR , but ,» say-AOR , « other.one province.in-INESS 1sg.gen mother-FOC still.be,.remain » say-AOR , « three brother-FOC still.be,.remain , two brother-FOC still.be,.remain » say-AOR .
« this pouring-OUT-INST that,same king-DIR-GEN over-SP-INEL say-IMP that » say-ENT , « 2SG-SBJ or dog be-FUT-OPT, or pig be-FUT-OPT » .	« this pouring.AOC-AOR that,.the.same king-DIR-GEN over-SPSS-INELAT say.IMP that » say-ENT , « 2sg-SBSS-EL or dog be.will-AOP , or pig be.will-AOP ».
he go-ENT again yard.in-iness-spss .	more-FOC go-AOR himself yard.in-INESS-SPSS .
they-to-also punishment-ORD » say-PST-PFV	they.to.also punishment order.IMPV » say-AOR .
twenty.three soldier-PL-ABL eight nation cop-PTP , Russian-PL-ERG many nation cop-PTP .	Twenty three soldier-ERG-SBSS-EL eight nation is-AOP 1pl.abs , russians.also-FOC very was , eight nation is-PST .
« sea-OBL bottom-DAT go.INF-POESS must » say-ENT , « sea-OBL-GEN steed.under-POESS with fight.FUT-ENT » say-ENT .	« sea-OBL-GEN want-ERG-DAT a.going.MSD for-INELAT-FOC 1sg.abs sea-OBL-GEN steed-ERG-POESS with-DAT fight.AOC want-IMPF » say-ENT .
and oldest girl-ERG younger-DAT say-AOR : « dear sister », say-AOR , 2SG.POS horse nothing-COP, say-AOR .	this elder sister-ERG small-OBL-DAT say-AOR : dear sister , say-AOR , 2sg.gen horse never , say-AOR .
table-PL ground.on put.PL , tablecloth-PL-OBL , all village-GEN child-PL there go.HAB	chairs.on-PL open-PST-ENT-PST ground.in-INESS-SPSS , tablecloths-PL-FOC , all village-ERG-GEN child-PL go-ENT-AOP .
this-Q bear-Q look.for-ENT but neg find-ENT .	turns 1pl.abs this bear-OBL-POESS , find-MSD not.make.PRF.PTP-AOP 1pl.gen-DAT .
one another love-INESS be-1PL , each.other love-INESS be-1PL .	our love-FOC one was , love-FOC one was .
that.time-INEF say-ENT , that people-ERG chase-FUT-IND say-ENT , 2sg king choose-FUT-IND say-ENT .	AT.THAT.TIME-INESS », say-ENT , « it will.chase.FUT-ENT public-ERG », say-ENT , « 2sg.abs king choose.IMP-INESS » say-ENT .
1sg.erg go-PFV-1sg.abs Derbent.in-OBL-GEN	1sg.abs go-PERF-PTP Derbent.in-OBL-DAT
« cut.off-IMPV their head-PL » say-AOR .	« cut.IMPV their chapter-PL » say-AOR .
come come.out water-SPSS , Bezkhanum	come come.out-ERG water.on , Bezkhanum
« soil-PL », say-AOR , « 1sg.ERG bring-INF-ERG 2sg.GEN eye-PL heal-INF-PL want-INF-INESS », say-AOR .	« soil-AD-PL », say-AOR , « 1sg.ERG brought.AOR-AOR absolutely 2sg.gen eye-PL heal.AOC-PL-AOR want-INESS », say-AOR .
after return-PFV 1pl-abs summer camp-DIR-DAT , rest-INF	after return-PERF 1pl.abs summer camp-DIR-DAT , to.have.a.rest-INF .
that Isabala-ERG 1sg.abs-DAT see-AOR say-AOC that , « Isabala brother , puppy-PL-DAT mother with give.birth , 1sg.ERG-DAT dog return IMPF-SBJV please .	Isabala seen-TEMP say-AOC that 1sg.ERG , « Isabala brother , puppy-PL-FOC be-AOR say-IMPF , give 1sg.gen dog .
today scale-OBL one-OBL plate-OBL on one-ERG person-ABS put-PROG-PST that , truth justice uprightness purity-ABS – that , another plate-OBL on .	then justice scale-DIR-AD one side.on put.IMPV-PERF that,.the.same man , another side.on-FOC – truth , justice , right-PURP , today-PURP , cleanless-PURP .
he-and TAKING.DOWN-AOC girl DECEIVING-AOC her HOUSE-OBL-DAT when-TAKING-TEMP this girl RAN-ENT his ARM-from	he.and taking.down.AOC girl deceiving.AOC her house-OBL-DAT when.taking.TEMP this girl ran.ENT his arm.from .
knock-PAST-1PL door-DEF one-OBL home-ABL man-KAZ come.out-PAST-3SG	run.IMP-AOR 1pl.erg one window-INESS , apperance-AOR here-SPSS , kazakh was
« call-IMP-ERG », say-AOR , « this boy today-ABL-ERG-ERG day.from be-FUT king , 1sg.ABS-FOC his wife .»	« call?-ERG », say-AOR , « this boy today-GEN-ERG-GEN day.from be-ENT king , 1sg.abs-FOC his wife .»
unfaithful , untrusted .	unfaithful , untrusted .
ZUNNI ER-men-i-DI-H TERSI-NA	1sg.abs-FOC armenian-DIR-POESS on.the.contrary
and-then third boy-ERG say-AOR: « dear father », say-AOR , « now 1sg.abs will.bring-ENT », say-AOR .	AT.THIS.TIME-INESS THIRD-PST boy-ERG say-AOR : « dear father », say-AOR , « now 1sg.ERG will.bring-INESS », say-AOR .
but , say-AOC , come-IMP-CVB next time-OBL , say-AOC , 1sg.ABS , say-AOC , mother-OBL-DAT one petition give-NEC-CVB .	but , say-AOC , come-ENT-PST time-INESS , say-AOC , come , say-AOR , mother-DIR-DAT one statement to.give you.know 1pl.erg .
heavy be-PTP-ABS snow-OBL-PLUR piece-PLUR be-3PL.PRS , piece-PLUR	snow-INESS-DIR-GEN small flake you.know , flake
2sg.gen remember-Q	2sg.gen heart-ERG-SPSS still.remember-Q ?)
well history-GEN this evidence-PL say-OPT-IMPF , history-GEN exactly from , know NEG -- yea , hmm , hmm , tell NEG-PRS say-ENT time-PL-ACC history-GEN-PL , show NEG-POT-PRS say-ENT time-PL-ACC you-DAT .	well , history-OBL-GEN this evidence-PL say-PST-TEMP , history-OBL-GEN FROM.EXACTLY , they you.know — Uhm , Uhm , time 1sg.ERG-AD-EL say-INF be-FUT-NEG , time-PL show be-FUT-NEG 1sg.ERG-AD-EL 2pl.dat-DAT .
1sg.abs Soviet-PL-INESS-ELA party-INESS go-CAUS-AOR-3SG , 1sg.ERG vacation get-AOR-3SG , ten day , time-PL-INESS that be-AOC	1sg.abs that soviets' time-DIR-DAT party-DIR-DAT take.over , 1sg.ERG-DAT vacation give-AOR ten 24.hour.period , such-PL be-AOR .
but, say-AOC, 3sg.abs go-PFV dam-LAT down	but , say-AOC , one down dam-INESS-SPSS go-MSD 1pl.abs .
now time-INDF , 1sg.abs , 1sg.abs until become-NEG	that-ERG-SPSS 1pl.erg , 1sg.abs , 1sg.abs in.the be ...
then on-1PL-GEN that return-AOR , captain .	then on 1pl.gen that return-AOR , captain .
"« ""Samur"" » newspaper-OBL-GEN fireplace-INESS fire exist-PRS-3SG"	"« ""Samur"" » newspaper-OBL-GEN fireplace-INESS today-FOC fire cop-IMPF ."
finish happened-AOR , be-PAST-1PL mortar-PL man-PL , there be-PAST three we-ERG	finish happened-AOR ... there-SPSS 1pl.abs mortar.men was , mine-PL threw.ENT-ENT-PST three person
IBU-ERG-PL-and him-ACC that-on and she-ACC throne-on seated-3PL .	They.and he put.ENT that.on and her throne.on seat.ENT .
child-DIM-OBL go-IMP !	die-IMP still.be,.remain !
"this boatman-OBL call-PAST-PL-ENT and ask-PAST-PL-ENT that ""brother you.OBL other.side-POSS sea-OBL-DAT take-NEC-FUT-ENT 1pl-DAT"""	called.ENT this boatman-DIR-DAT say-ENT that , « dear brother , 1pl.abs » say-ENT « sea-OBL-GEN other bank-ERG-DAT get.out-AOR want-ENT 2sg.abs-ERG ».
DEAR Bezkhanum , DEAR Bezkhanum	soul Bezkhanum , soul Bezkhanum
to.gather-AOR man-PL call-IMPV-ENT all .	to.gather-AOR man-PL call.IMPV-ENT all .
it-OBL why 3sg.OBL-DIR guide-PRS	what.for for took ?
and-then third boy-ERG say-AOR : « dear father », say-AOR , « now 1sg.abs will.bring-ENT », say-AOR .	AT.THIS.TIME-INESS THIRD-PST boy-ERG say-AOR : « dear father », say-AOR , « now 1sg.ERG will.bring-INESS », say-AOR .
1sg-abs-FOC bread eat-pst-1pl.erg , three-erg , 1sg-abs-FOC water go.to.drink-pst	1sg.abs-FOC bread ate-AOC , 1pl.erg three-ERG , 1sg.abs-FOC water-SPSS go-AOR .
« very 2sg.abs attention-DIR-DAT go-PERF that »	« very 2sg.abs attention-DIR-DAT go-PERF that ».
1sg.gen mother teacher was , 1sg.gen father accountant was .	my mother teacher was , my grandfather-AND accountant was .
and then return-AOR free-ADJ be.free-PRES , home-ABL , family-with	then return-AOR free , thing-OBL-GEN , family-OBL-DAT
one escape-IMPF .	one escape-IMPF .
1sg.abs-mind change-NEG-PFV say-IMPF	decision-DIR-SPSS-EL 1sg.abs separated isn't , say-IMPF .
and.that after-OBL early unexpected sergeant rank get 1SG	there-SPSS-EL after 1sg.ERG-DAT earlier rank sergeant give-AOR .
like.that happened-AOP-TEMP ashuq-DIR what say-IMPF	like.that happened-AOP-TEMP love-DIR what say-IMPF ?
go-ENT 1sg.abs shepherd-DIR-GEN yard.in-INESS-SPSS .	go-ENT 1sg.abs shepherd-DIR-GEN yard.in-INESS-SPSS .
no , sea-OBL-GEN on surface NEG.be.PTP-COND , 1sg.abs exist.NEG-CONJ », say-INESS .	no , sea-OBL-GEN on blood apperance NEG.make.PTP-COND , 1sg.abs exist.doesn't », say-INESS .
coming-PST-TEMP, « oh boy », say-ENT, « 2sg.DAT-POSS voice coming-AOR, say-AOR, 2sg.GEN house-INESS pearl-PL cop » say-AOR.	coming-PST-TEMP , « oh boy », say-ENT , « 1sg.ERG-DAT voice coming-AOR , say-AOR , 2sg.gen house-INESS pearls-PL cop » say-AOR .
then after 1pl.abs Chukotka-ALL go	there.from after to.go-HORT 1pl.abs Chukotka-ERG-DAT .
and community-from-SBJV-SPSS agree God bless-PST	he-AOP people-DIR-SPSS-INELAT Allah agree let.it.be.OPT .
this time-OBL , 1pl.abs other-ALL offend-CAUS-RECIP be-AOR .	2sg.abs 1sg.ERG-SBSS-EL , 1sg.abs 2sg-SBSS-EL worry was time-PL-Q be-AOR .
there .	there .
but past in awesome was .	that times commonly disaster was .
and take.out-FUT-1PL water , that time take.out-FUT-1PL 3SG.M-ERG water-from	this let.us.out so.much , 1pl.erg water let.us.out so.much time-OBL-SPSS .
these-ERG take-ENT this picture put-IMPV-ENT spring-INESS .	these-ERG-Q take-ENT this picture put.IMPV-ENT spring-INESS-SPSS .
so 1sg-ERG one boy-OBL face see-PST-1SG that 1pl-GEN one A.LITTLE resemble	that,.the.same like.this , one boy look-AOC 1sg.ERG-DAT ours similar was face-INELAT one A.LITTLE .
guy-ERG and attention-ENT , « I-ABS wonder » say-PAST-ENT « 1SG-ABS go-PTCP-SUB before girl here put-PTCP-ABS if do grandfather-ERG come-PRS-OPT girl steal-INF again do-PAST-ENT-REL .	guy.ERG.and attention-ENT , « I.wonder » say-ENT « 1sg.abs going.PTP.COND before girl here puting.AOC if.do grandfather-DIR coming-AOR girl steal.INF did.again.ENT-INESS .
after.all very think-MSD-off after girl boarding boat-INESS , send-ENT this girl boat-in.being.IMC other side	after.all very a.thinking.MSD.off after girl boarding.AOC boat-INESS , sent.ENT this girl boat.in.being.IMC other side .
"this boatman-OBL call-PAST-PL-ENT and ask-PAST-PL-ENT that ""brother you.SG-OBL sea-OBL other.side-INESS take-NEC-FUT-ENT us-ACC"""	called.ENT this boatman-DIR-DAT say-ENT that , « dear brother , 1pl.abs » say-ENT « sea-OBL-GEN other bank-ERG-DAT get.out-AOR want-ENT 2sg.abs-ERG ».
1pl-abs two escape-past-decl	1pl.abs two escaped-AOR .
nan	04 : 19
that~time-INE say-ENT , « 3pl-NOM it chase-FUT-PL-INDF », say-ENT , « 2sg-ERG king choose-FUT-INDF » say-ENT .	AT.THAT.TIME-INESS », say-ENT , « it will.chase.FUT-ENT public-ERG », say-ENT , « 2sg.abs king choose.IMP-INESS » say-ENT .
battalion-OBL-GEN land surveyor be-HAB 1sg.abs	battalion's-DIR-GEN land.surviver was 1sg.abs
May in engage-IR-1PL-DAT , September in married be-IR-1PL	May-OBL-DAT engagament be-AOR , sentyabr-OBL-DAT 1pl.abs married be-AOR .
« this so not.be », say-ENT .	« like.that will.not.be that », say-ENT .
word-ERG-GEN say-IMPF this chapter-EL new love.song-ACC Bezkhanuma-DAT write-PFV	love-PL-ERG-DAT her-GEN new chapter-EL song-PL created-AOR Bezkhanum-ERG-DAT :
we-ERG with friendly very be-AOR , kind be-AOR	brother-PL-OBL-POESS with kind happened-AOC , good happened-AOR .
1SG.ABS - say-AOR help do 1SG.ABS take-back say-AOR HERE-ERG leave-PROH say-AOR	1sg.abs , say-AOR , help do , 1sg.abs take.back , say-AOR , here-ERG leave-PROH , say-AOR .
himself-ERG-GEN son way-ERG-DAT want be.FUT.Q	himself-ERG-GEN son way-ERG-DAT want be.FUT.Q ?
well , say-IMPF , Bezkhanum-ERG , say-IMPF , world-ILL-DAT one word-OBL give-NEC-PRS , ashuq-DAT even if-CON all.thing-PL-ERG 2sg.abs-against be-FUT-3PL .	but , say-IMPF , Bezkhanum , say-IMPF , world.on-INESS all one side if.is , ashuq-DIR-DAT 2sg.abs-ERG word give-AOR want-FUT .
« dear old-woman grandmother » say-ENT, « 2SG-DAT girl want-ENT-NEG », say-ENT, « 2SG-DAT one baby want-ENT-NEG », say-ENT?	« dear old.woman grandmother » say-ENT , « 2sg-DAT girl want-ENT-FOC », say-ENT , « 2sg-DAT one baby want-ENT-FOC », say-ENT ?
release.IMMANT-IMC FLEW-AOR coming-AOR this bird sitting.down-AOR girl-ERG-GEN shoulder-INESS-SPSS .	release.IMMANT-IMC FLEW-AOR coming-AOR this bird sitting.down.AOC-ENT girl-ERG-GEN shoulder-INESS-SPSS .
« now bring.IMPV.Q-FOC 1sg.AG-2sg.DAT », say-ENT , « 1sg.AG-POESS touch.NEG-NEG.PROH only »	« now-INESS bring.IMPV.Q-FOC 1sg.ERG 2sg-DAT », say-ENT , « 1sg.ERG-POESS touch.not.PROHIB-PROH only ».
we there village one reach	1pl.abs return-AOR this one there village-ERG-DAT
horse-ERG say-ENT : « what happen-PERF », say-ENT , « that-GEN head down-AOR that », say-ENT , « what happen-PERF , what think-PL-IMPF ?»	horse-ERG say-ENT : « what happened-PERF », say-ENT , « more-FOC head hang.AOC-AOR that », say-ENT , « what happened-PERF , what attention-PL-IMPF ?»
