predicted_glosses	glosses
when IPFV-CN young-SG CCNJ young-SG DEM LVB-1SG.II LOC-CN still young-SG CCNJ come.over-3.II REL live-CN Gitsegyukla	still IPFV-CN small-little-1SG.II still small-little-1SG.II time COMP-CN toward come-CN PART relative PREP-OBL-CN LOC-CN Gitsegyukla
still live-IPFV=EPIS=CN-1PL.II LOC-CN house POSS-3PL.INDP mother father CONNN and believe-1PL.II	still IPFV-CN live-1PL.II LOC-CN in house-PN mother-1PL.II PCNJ father-1PL.II
CCNJ come.over-1SG Man name CCNJ come.over-1SG Jacob Brown	CCNJ toward come-PN Man-CN name-3.II Man toward arrive Jacob Brown
CCNJ want-1SG.II PROSP tell-3.II story LOC past hunt-3SG.II	CCNJ want-3.II PROSP-3.I tell-T-CN MANR LVB-3.II COMP IPFV-CN hunt-ANTIP-3.II
CCNJ INCEP NEG 3SG.II go PROSP before	CCNJ INCEP IPFV PROSP away go-3.II
CCNJ-CN gather-3.II everything-CN PROSP use-TR-3.II PROSP catch-TR-3.II what hunt-IPFV-EPIS=CN-3.II	CCNJ-3.I take.PL-CN all 3.III-CN CNT.AMT-CN PROSP use-TR-3.II PROSP MANR CIRC.PSBL hunt-ANTIP-3.II
CCNJ want PROSP tell-TR=3PL 1PL.II manner how do-3SG.II	CCNJ want-3.II PROSP-3.I tell-T-3.II OBL-1PL.II MANR LVB-3.II
CCNJ make-CAUS1-3.II CCNJ-3.II sit-TR-PASS-1PL.II CCNJ 1SG.II CCNJ brother-SG sister-PL	CCNJ-3.I sit.PL-T-1PL.II sit-T-TR-3.II 1PL.III 1SG.III PCNJ-CN PL-sibling-PASS-1SG.II
"CCNJ 1.I-CCNJ OBL-3SG.II say-IPFV=EPIS=CN , "" PROSP tell-FUT-1SG OBL-2SG PROSP=3 ."""	CCNJ on COMP say-3.II PROSP tell-T-TR-1SG.II PN-DEM.PROX OBL-2SG.II
PROG=CN-IPFV PROSP hunt-1SG.II CCNJ CCNJ-CCNJ 1.I-CCNJ grouse-SG OBL-3.II 1.I-CCNJ way-LOC=CN, he-said	IPFV-CN go-1SG.II PROSP hunt-ANTIP-1SG.II CCNJ sit-CN grouse block.way sit-CN grouse QUOT.3SG 3.III
CCNJ NEG 1SG see-TR moose	CCNJ 1.I see-CN moose
because-CN want-INS feed-TR-1SG.II PROSP for CN village	IPFV-CN want-1SG.II PROSP 1.I eat-CAUS2-CN contain-village.people-1SG.II
CCNJ if move-IRR-1SG say-3SG	CCNJ IRR-SPT move-PASS-1SG.II QUOT.3SG
PROSP COMP fly-away-3 CCNJ PROSP COMP run-away-3 . DET-moose=CN DET-want-1.SG.= .	PROSP CCNJ fly-CN grouse PROSP CCNJ flee.PL-CN moose want-1SG.II
CCNJ NEG-1.I make-CN sound-OBL Man	CCNJ on COMP NEG-FOC SUPER-make.noise-PASS-PN Man
PROSP sit-3SG.II still VER look-3SG.II at 1PL look-PROSP at what 1PL.II VERUM do-IPFV=EPIS=CN look-PROSP at how 1PL.II VERUM be-IPFV	keep.on sit 3.III see-3.II 1PL.III see-3.II MANR make-T-TR-1PL.II see-3.II MANR LVB-1SG.II
CCNJ-1PL.II 3.SG.II-say-CN what do-3SG.II-CN .	CCNJ-1.I 1PL.I ask what-CN LVB-3.II
what-Q shoot-CN bird.grouse-or-CN moose-or-CN	what-CN CONTR shoot-TR-2SG.II grouse IRR DWID moose
CCNJ then 3.I sit-CN	CCNJ on COMP sit-3.II
CCNJ say-3.II CCNJ if-CN I shoot-IPFV grouse	CCNJ say-3.II IRR-SPT 1.I shoot grouse
if CCNJ 1.I shoot-CN grouse PROSP CCNJ 1.I alone eat-FUT=3	IRR-SPT 1.I shoot grouse PROSP CCNJ only one.HUM 1SG.III PROSP eat-PASS-SX
CCNJ if wait-IPFV-1SG.II until PROSP walk-TR-3 grouse	CCNJ IRR-SPT wait-ANTIP-1SG.II completely PROSP NMLZ away go-CN grouse
PROSP PROG=CN walk-1SG.II DEM.PROX close=CN moose CCNJ VERUM PROSP arrive-1SG.II DEM.PROX very.near=CN moose	PROSP CCNJ-1.I CIRC.PSBL PROSP toward go LOC-CN little-ATTR toward close-CAUS2-ANTIP-1SG.II LOC-CN moose
FUT PROSP COMP shoot-TR-1SG.II COMP all people eat-TR-3PL	PROSP CCNJ-1.I CIRC.PSBL PROSP 1.I shoot-3.II PROSP CCNJ eat.PL-PASS-CN all 3.III-CN people
CCNJ after PROSP finish tell-TR-3PL OBL-1PL.INDP CCNJ go-TR-3SG.II home	CCNJ on COMP finish-PASS-3.I tell-T-3.II OBL-1PL.II CCNJ leave go.home-3.II
CCNJ then after two day.PL.INDP after CCNJ DEM.PROX-3.SG.II see-1SG.II again	CCNJ INCEP two day finish-SX away leave-SX time COMP-CN 1.I just-again see-3.II
CCNJ run-1SG.II toward PN, CCNJ and then say-1SG.II to PN:	CCNJ toward run-1SG.II LOC-3.II CCNJ on COMP say-1SG.II OBL-3.II
NEG=VERUM know-1SG.II DEM happen-T.IPFV=EPIS=CN about grouse DEM ask-2SG	NEG-2.I CIRC.PSBL PROSP-2.I tell-T-CN MANR LVB-CN grouse PR.EVID
CCNJ then tell-TR-3SG.II PROSP over LOC=CN your.OBL mother house and PROSP tell-VER-1SG.II you	CCNJ on COMP say-3.II PROSP toward arrive 1SG.III LOC-CN house-PN mother-2SG.II PROSP CCNJ-1.I tell-T-3.II OBL-2SG.II
CCNJ go-1SG.II home CCNJ DEM.PROX-CCNJ wait-EPIS-1SG.II 3.I, CCNJ DEM.PROX-tell-TR-3.I 1SG.II-OBL grouse	CCNJ back go.home-1SG.II CCNJ 1.I wait-ANTIP-1SG.II OBL-3.II CCNJ-3.I tell-T-CN MANR LVB-CN grouse
CCNJ PROG-3 tell-IPFV-3 CCNJ then say-3	CCNJ IPFV-3.I tell-T-3.II CCNJ on COMP say-3.II
PROG=CN hunt-IPFV=EPIS=CN CCNJ want-1PL.II get-PROSP moose-T	IPFV-CN hunt-ANTIP-1SG.II CCNJ want-1PL.II PREP-OBL-CN moose
CCNJ want-PROSP feed-TR all people-PL CCNJ but grouse-SG LOC=CN way-CN	CCNJ want-1PL.II PROSP eat-CAUS2 all 3.III-CN people CCNJ block.way sit-CN grouse
CCNJ PROSP move-1SG.II PROSP fly-PASS-3SG.II grouse	CCNJ IRR-SPT move-PASS-1SG.II PROSP CCNJ fly grouse
CCNJ that CLF grouse-SG start-CN fly-TR make-CN sound betl'a betl'a betl'a betl'a betl'a .	CCNJ on COMP say-PN Man flap flap flap flap QUOT.3SG PROSP MANR fly-CN grouse
as.soon.as-CCNJ 1.I-move-IPFV-1SG.II CCNJ VERUM 1.I-move-IPFV-1SG.II break-TR-1SG stick-CN	true on COMP move-PASS-1SG.II QUOT.3SG true on COMP move-PASS-1SG.II break-CAUS2-1SG.II-CN stick
VERUM noisy grouse-PL fly-IPFV=EPIS=CN CCNJ VERUM hear-able-2SG 1.I fly-IPFV=EPIS=CN 1SG.II CNTR-again: betl'a betl'a betl'a betl'a betl' .	CCNJ noisy-CN COMP-FOC-3.I fly.PL-CN grouse CCNJ on COMP fly-3PL.II CCNJ-2.I hear-3.II flap flap flap flap flap
CCNJ NEG-really want-EPIS-1SG.II PROSP move-1SG.II PROSP run.away-FUT moose game-1SG.II NEG-run.away-FUT because.of grouse there-be-EPIS-CN	CCNJ NEG-FOC want-1SG.II PROSP NMLZ move-PASS-1SG.II PROSP MANR flee.PL-CN moose hunt-ANTIP-1SG.II COMP block.way sit-CN grouse
every-time-CN see-CN Man Jacob Brown CCNJ 3SG.II-CCNJ ask-CN 3SG.II PROSP tell-T-TR 1PL.II story-CN betl'a betl'	COMP-1.I HAB see-PN Man Jacob Brown CCNJ 1.I again ask-3.II NEG-2.I CIRC.PSBL PROSP-2.I tell-T-CN MANR LVB-CN flap flap OBL-1PL.II-Q
CCNJ 1.I-CCNJ PREP name-TR-CN OBL-3.II Man Betl'a Betl'	CCNJ on COMP CAUS1-sit-DETR-ATTR CAUS1-name-T-TR-1SG.II-DM Man Betl'a Betl'
CCNJ REAS COMP call-PASS-1SG.II now Betl'a Betl'	on REAS COMP-CN name-1SG.II now PREP-PN Betl'a Betl'
DEM.PROX-say-VERUM	CNT.AMT-CN say-1SG.II
