predicted_glosses	glosses
« 1SG.ABS », say-AOR , « go-AOR man-ERG-GEN between-INESS enter-FUT-FUT , look-HORT maybe 1SG.GEN fate-INESS cop .»	« 1sg.abs », say-AOR , « go-AOR man-ERG-GEN between-INESS enter.FUT-FUT , look.HORT maybe 1sg.gen fate-INESS cop .»
decision one be-3SG	agreement-PL one was .
« And.but 1PL.ABS they-ERG-GEN to return-AOR want-ENT , come group happen-AOR go.back-HORT 1PL.ABS .»	« And.but 1pl.abs them-ERG-GEN to returned-AOR want-ENT , come group happened-AOR go.back.HORT 1pl.abs .»
what-ABS this cop , ashuq boy cop	love what was , ashuq boy ?
what-ERG-DAT , where be-AOR ?	what-DAT , where be-AOR ?
good many say-AOR , happen-AOR , 1pl.abs event-INESS happy all be-AOR .	good toasts-PL say-AOR , agreements-PL be-AOR , 1pl.abs event.from-OBL-SUPER-EL agree remain-AOR .
well Chukotka very cold be-AOP was , very cold be-PST was .	well Chukotka cold place was , cold place was .
( Natavan )	( Natavan ).
they-ERG « call.IMPV that young.man » say-ENT , « they 2sg-DAT take.IMPV » say-ENT , « they he-DAT fitting cop.NEG ».	they-ERG « call.IMPV that boy » say-ENT , « they 2sg-DAT take.IMPV » say-ENT , « they he-DAT worthy cop.NEG ».
then this boy-ERG say-ENT that , « but now all happened-PERF », say-ENT , « grandfather-DIR-FOC punishment take-AOR , others.and-ERG-FOC punishment take-AOR , but ,» say-AOR , « other.one province.in-INESS 1sg.gen mother-FOC still.be,.remain » say-AOR , « three brother-FOC still.be,.remain , two brother-FOC still.be,.remain » say-AOR .	then this boy-ERG say-ENT that , « but now all happened-PERF », say-ENT , « grandfather-DIR-FOC punishment take-AOR , others.and-ERG-FOC punishment take-AOR , but ,» say-AOR , « other.one province.in-INESS 1sg.gen mother-FOC still.be,.remain » say-AOR , « three brother-FOC still.be,.remain , two brother-FOC still.be,.remain » say-AOR .
« this pouring-AOR that,same king-DIR-GEN over-SPSS-INELAT say.IMP that » say-ENT , « 2sg-SBSS or dog be-FUT, or pig be-FUT ».	« this pouring.AOC-AOR that,.the.same king-DIR-GEN over-SPSS-INELAT say.IMP that » say-ENT , « 2sg-SBSS-EL or dog be.will-AOP , or pig be.will-AOP ».
again go-AOR yard.in-INESS-SPSS .	more-FOC go-AOR himself yard.in-INESS-SPSS .
they.to.also PUNISH-IMP-PL » SAY-PAST .	they.to.also punishment order.IMPV » say-AOR .
twenty three soldier-PL-from eight nation-PL is-PST-Q , Russian-PL-OBL many be-PST , nation-PL is-PST .	Twenty three soldier-ERG-SBSS-EL eight nation is-AOP 1pl.abs , russians.also-FOC very was , eight nation is-PST .
« sea-OBL-GEN bottom go-GEN 1sg.abs sea-OBL-GEN steed-POESS with fight-NEC-COND 1sg.abs must », say-ENT .	« sea-OBL-GEN want-ERG-DAT a.going.MSD for-INELAT-FOC 1sg.abs sea-OBL-GEN steed-ERG-POESS with-DAT fight.AOC want-IMPF » say-ENT .
this elder sister-ERG say-AOR that : dear sister , say-AOR , 2sg.gen horse never , say-AOR .	this elder sister-ERG small-OBL-DAT say-AOR : dear sister , say-AOR , 2sg.gen horse never , say-AOR .
table-PL-OBL-DAT ground-INESS put-IMPF-PST tablecloth-PL-OBL-DAT , all village-GEN child-PL go-IMPF-PST .	chairs.on-PL open-PST-ENT-PST ground.in-INESS-SPSS , tablecloths-PL-FOC , all village-ERG-GEN child-PL go-ENT-AOP .
go-AOR-PTP 1pl.abs this bear-ERG-POSS but find-IMPF-NEG 3pl.abs .	turns 1pl.abs this bear-OBL-POESS , find-MSD not.make.PRF.PTP-AOP 1pl.gen-DAT .
each.other love-INESS-SPSS one be-1PL , love-GEN one be-1PL .	our love-FOC one was , love-FOC one was .
« that time » say-ENT « people-ERG-GEN outside chase-FUT-ENT », say-ENT « 2sg.abs king choose-FUT-ENT » say-ENT .	AT.THAT.TIME-INESS », say-ENT , « it will.chase.FUT-ENT public-ERG », say-ENT , « 2sg.abs king choose.IMP-INESS » say-ENT .
1sg.abs go-PERF-PTP Derbent-DAT	1sg.abs go-PERF-PTP Derbent.in-OBL-DAT
« cut.off-IMPV their head-PL » say-AOR .	« cut.IMPV their chapter-PL » say-AOR .
come come.out water-SPSS , Bezkhanum	come come.out-ERG water.on , Bezkhanum
« soil-AD-PL », say-AOR , « 1sg.ERG bring-AOR-AOR absolutely 2sg.GEN eye-PL heal-AOC-PL-AOR want-INESS », say-AOR .	« soil-AD-PL », say-AOR , « 1sg.ERG brought.AOR-AOR absolutely 2sg.gen eye-PL heal.AOC-PL-AOR want-INESS », say-AOR .
after return-PERF 1pl.abs summer camp-DIR-DAT , to.rest-INF .	after return-PERF 1pl.abs summer camp-DIR-DAT , to.have.a.rest-INF .
when Isabala-OBL see-AOR that , « Isabala brother , dog-PL-GEN birth give-IMPF-PTP-PST , return-IMP 1sg.DAT dog , please » .	Isabala seen-TEMP say-AOC that 1sg.ERG , « Isabala brother , puppy-PL-FOC be-AOR say-IMPF , give 1sg.gen dog .
that plate-INESS-PL-DAT one person put.IMPV-IMPF that,.the.same truth justice uprightness purity on another plate-INESS-DAT	then justice scale-DIR-AD one side.on put.IMPV-PERF that,.the.same man , another side.on-FOC – truth , justice , right-PURP , today-PURP , cleanless-PURP .
he-ERG taking-down-AOR girl deceiving-AOR her house-ALL-DAT when taking-TEMP this girl ran-ENT his from	he.and taking.down.AOC girl deceiving.AOC her house-OBL-DAT when.taking.TEMP this girl ran.ENT his arm.from .
we.two knock-AOR one door , apperance-AOR here-SPSS , kazakh was	run.IMP-AOR 1pl.erg one window-INESS , apperance-AOR here-SPSS , kazakh was
« call?-ERG », say-AOR , « this boy today-GEN-ERG-GEN day.from be-ENT king , 1sg.abs-FOC his wife .»	« call?-ERG », say-AOR , « this boy today-GEN-ERG-GEN day.from be-ENT king , 1sg.abs-FOC his wife .»
unfaithful , untrusted .	unfaithful , untrusted .
1SG.ABS-FOC ARMENIAN-DIR-POSS ON.THE.CONTRARY	1sg.abs-FOC armenian-DIR-POESS on.the.contrary
at.this.time three-ORD boy-ERG say-AOR : « dear father », say-AOR , « now 1sg.ERG that.thing-ACC bring-FUT », say-AOR .	AT.THIS.TIME-INESS THIRD-PST boy-ERG say-AOR : « dear father », say-AOR , « now 1sg.ERG will.bring-INESS », say-AOR .
but , say-AOC , two time-INESS book-to , say-AOC , come , say-AOC , mother-DIR-DAT give one petition that 1pl.erg .	but , say-AOC , come-ENT-PST time-INESS , say-AOC , come , say-AOR , mother-DIR-DAT one statement to.give you.know 1pl.erg .
heavy snowflake know you.know snowflake	snow-INESS-DIR-GEN small flake you.know , flake
2sg.gen heart-OBL-SPSS remember-Q	2sg.gen heart-ERG-SPSS still.remember-Q ?)
well , history-GEN this evidence-PL say-IMC , history-GEN exactly from , they uhm , uhm , time say-IMC can-NEG , time-PL show can-NEG .	well , history-OBL-GEN this evidence-PL say-PST-TEMP , history-OBL-GEN FROM.EXACTLY , they you.know — Uhm , Uhm , time 1sg.ERG-AD-EL say-INF be-FUT-NEG , time-PL show be-FUT-NEG 1sg.ERG-AD-EL 2pl.dat-DAT .
1sg.abs a Soviet-ERG-GEN time-INESS party-DAT accept-AOR , 1sg.ERG-DAT vacation give-AOR ten day , all-PL-ERG-GEN happened-AOR .	1sg.abs that soviets' time-DIR-DAT party-DIR-DAT take.over , 1sg.ERG-DAT vacation give-AOR ten 24.hour.period , such-PL be-AOR .
but , say-AOR , one dam-INESS go-MSD will.go-FUT that	but , say-AOC , one down dam-INESS-SPSS go-MSD 1pl.abs .
this three , 1sg.abs , 1sg.abs head-POSS on no.longer.want-AOR ...	that-ERG-SPSS 1pl.erg , 1sg.abs , 1sg.abs in.the be ...
then on 1pl.gen that return-AOR , captain .	then on 1pl.gen that return-AOR , captain .
"« ""Samur"" » newspaper-OBL-GEN fireplace-OBL-INESS fire still.be-IMPF"	"« ""Samur"" » newspaper-OBL-GEN fireplace-INESS today-FOC fire cop-IMPF ."
finish be-AOC ... that-OBL-SPSS mortar man be-AOP , we three be-PST	finish happened-AOR ... there-SPSS 1pl.abs mortar.men was , mine-PL threw.ENT-ENT-PST three person
They.and he put.ENT that.on and her throne.on seat.ENT .	They.and he put.ENT that.on and her throne.on seat.ENT .
say-IMPV he-FOC !	die-IMP still.be,.remain !
call-AOR this boatman-DIR-FOC say-ENT that , « was brother , 1pl.abs » say-ENT « sea-OBL-GEN other.side-INESS take-AOR take.out-AOC want-FUT 2sg.abs-ERG 1pl.ACC ».	called.ENT this boatman-DIR-DAT say-ENT that , « dear brother , 1pl.abs » say-ENT « sea-OBL-GEN other bank-ERG-DAT get.out-AOR want-ENT 2sg.abs-ERG ».
soul Bezkhanum , soul Bezkhanum	soul Bezkhanum , soul Bezkhanum
to.gather-AOR man-PL call-IMPV-ENT all .	to.gather-AOR man-PL call.IMPV-ENT all .
it-ERG-DAT why take	what.for for took ?
this-time three-ORD-ERG boy-ERG say-AOR : « dear father », say-AOR , « now 1sg.ERG that.thing-AOR bring-AOR », say-AOR .	AT.THIS.TIME-INESS THIRD-PST boy-ERG say-AOR : « dear father », say-AOR , « now 1sg.ERG will.bring-INESS », say-AOR .
1SG.ABS-FOC BREAD EAT-AOC , 1PL.ERG THREE-ERG , 1SG.ABS-FOC WATER-SPSS GO-AOR .	1sg.abs-FOC bread ate-AOC , 1pl.erg three-ERG , 1sg.abs-FOC water-SPSS go-AOR .
« very 2sg.abs think-DIR-DAT go-PERF that ».	« very 2sg.abs attention-DIR-DAT go-PERF that ».
this mother teacher cop-PTP was , this father-GEN accountant cop-PTP was .	my mother teacher was , my grandfather-AND accountant was .
then return-AOR free , now , family-ERG-DAT	then return-AOR free , thing-OBL-GEN , family-OBL-DAT
one run-IMPF .	one escape-IMPF .
today-OBL-SUPER-EL change-AOR-NEG 1sg.abs mind-ABS NEG.be-IMPF-AOR , say-IMPF .	decision-DIR-SPSS-EL 1sg.abs separated isn't , say-IMPF .
after.that 1sg.ERG-DAT early honorary sergeant give-AOR .	there-SPSS-EL after 1sg.ERG-DAT earlier rank sergeant give-AOR .
like.that be-AOP-TEMP ashuq-DIR what say-IMPF	like.that happened-AOP-TEMP love-DIR what say-IMPF ?
go-ENT 1sg.abs shepherd-DIR yard.in-INESS-SPSS	go-ENT 1sg.abs shepherd-DIR-GEN yard.in-INESS-SPSS .
no , sea-OBL-GEN on blood apperance NEG.make.PTP-COND , 1sg.abs exist.NEG », say-INESS .	no , sea-OBL-GEN on blood apperance NEG.make.PTP-COND , 1sg.abs exist.doesn't », say-INESS .
coming-PST-TEMP , « oh boy », say-ENT , « 1sg.ERG-DAT voice coming-AOR , say-AOR , 2sg.GEN house-INESS pearls-PL cop » say-AOR .	coming-PST-TEMP , « oh boy », say-ENT , « 1sg.ERG-DAT voice coming-AOR , say-AOR , 2sg.gen house-INESS pearls-PL cop » say-AOR .
there-PST after go-AOR 1pl.abs Chukotka-DIR-DAT .	there.from after to.go-HORT 1pl.abs Chukotka-ERG-DAT .
and God other-PL-ERG-GEN blessing-SBST-AOP be-PST .	he-AOP people-DIR-SPSS-INELAT Allah agree let.it.be.OPT .
sometimes each.other-INESS-DAT 1sg.abs 1pl.abs-DAT offend-IMPF-PST be-AOR .	2sg.abs 1sg.ERG-SBSS-EL , 1sg.abs 2sg-SBSS-EL worry was time-PL-Q be-AOR .
there .	there .
that past-INESS commonly disaster was .	that times commonly disaster was .
until let.us.out-AOR 1pl.erg this , 1pl.erg tea let.us.out-AOR 1pl.abs .	this let.us.out so.much , 1pl.erg water let.us.out so.much time-OBL-SPSS .
these-ERG take-ENT this picture put.IMPV-ENT spring-INESS .	these-ERG-Q take-ENT this picture put.IMPV-ENT spring-INESS-SPSS .
that and I one boy see-AOR 1sg.ERG-DAT face resemble-IMPF-PST little our .	that,.the.same like.this , one boy look-AOC 1sg.ERG-DAT ours similar was face-INELAT one A.LITTLE .
boy-DIR-GEN-ERG and attention-ENT , « I.wonder » say-ENT « 1SG-ABS go-PTCP-COND before girl here put-AOR if-do grandfather-DIR come-AOR girl steal-INF do-again-ENT-INESS .	guy.ERG.and attention-ENT , « I.wonder » say-ENT « 1sg.abs going.PTP.COND before girl here puting.AOC if.do grandfather-DIR coming-AOR girl steal.INF did.again.ENT-INESS .
after.all very think-MSD-off after girl board-AOC boat-INESS , send-ENT this girl boat-in.being.IMC other side	after.all very a.thinking.MSD.off after girl boarding.AOC boat-INESS , sent.ENT this girl boat.in.being.IMC other side .
they-ERG this boatman-DIR-DAT said-ENT that , « dear brother », say-ENT , « sea-OBL-GEN other.side-INESS-SPSS you 1pl.abs take-IMPV want-ENT 2sg.abs ».	called.ENT this boatman-DIR-DAT say-ENT that , « dear brother , 1pl.abs » say-ENT « sea-OBL-GEN other bank-ERG-DAT get.out-AOR want-ENT 2sg.abs-ERG ».
1PL.ABS TWO ESCAPE-AOR .	1pl.abs two escaped-AOR .
04 : 49	04 : 19
« that time », say-ENT, « people-PL-GEN chase-FUT-ENT », say-ENT, « 2sg.abs king choose.FUT-ENT » say-ENT .	AT.THAT.TIME-INESS », say-ENT , « it will.chase.FUT-ENT public-ERG », say-ENT , « 2sg.abs king choose.IMP-INESS » say-ENT .
battalion-DIR-GEN land.surveyor cop-PST was 1sg.abs	battalion's-DIR-GEN land.surviver was 1sg.abs
May-INESS happen-AOR , September-INESS go-AOR married be-AOC .	May-OBL-DAT engagament be-AOR , sentyabr-OBL-DAT 1pl.abs married be-AOR .
« no way », say-ENT .	« like.that will.not.be that », say-ENT .
he-ERG this-OBL-DAT new love song write-AOR Bezkhanum-DAT :	love-PL-ERG-DAT her-GEN new chapter-EL song-PL created-AOR Bezkhanum-ERG-DAT :
friendly very be-AOC , good be-AOC .	brother-PL-OBL-POESS with kind happened-AOC , good happened-AOR .
1SG.ABS , SAY-AOR , HELP DO , 1SG.ABS TAKE.BACK , SAY-AOR , HERE-ERG LEAVE-PROH , SAY-AOR .	1sg.abs , say-AOR , help do , 1sg.abs take.back , say-AOR , here-ERG leave-PROH , say-AOR .
HIMSELF-ERG-GEN SON WAY-ERG-DAT WANT BE.FUT.Q	himself-ERG-GEN son way-ERG-DAT want be.FUT.Q ?
but , say-IMPF , Bezkhanum-ERG , say-IMPF , world-INESS even if one all 2sg-POSS be-FUT-3pl-AGAINST , ashuq-ERG-DAT 2sg.erg word give-AOC want-FUT .	but , say-IMPF , Bezkhanum , say-IMPF , world.on-INESS all one side if.is , ashuq-DIR-DAT 2sg.abs-ERG word give-AOR want-FUT .
« dear old-woman grandmother » say-ENT , « 2sg-DAT girl want-ENT-FOC », say-ENT , « 2sg-DAT one baby want-ENT-FOC », say-ENT ?	« dear old.woman grandmother » say-ENT , « 2sg-DAT girl want-ENT-FOC », say-ENT , « 2sg-DAT one baby want-ENT-FOC », say-ENT ?
release.IMMANT-IMC FLEW-AOR coming-AOR this bird sitting.down.AOC-ENT girl-ERG-GEN shoulder-INESS-SPSS .	release.IMMANT-IMC FLEW-AOR coming-AOR this bird sitting.down.AOC-ENT girl-ERG-GEN shoulder-INESS-SPSS .
« now-INESS bring.IMPV.Q-FOC 1sg.ERG 2sg-DAT », say-ENT , « 1sg.ERG-POESS touch.not.PROHIB-PROH only ».	« now-INESS bring.IMPV.Q-FOC 1sg.ERG 2sg-DAT », say-ENT , « 1sg.ERG-POESS touch.not.PROHIB-PROH only ».
1PL-ABS there arrive-AOR and one there village-ERG-DAT	1pl.abs return-AOR this one there village-ERG-DAT
horse-ERG say-ENT : « what happened-PERF », say-ENT , « more-FOC head down-AOR that », say-ENT , « what happened-PERF , what think-PL-IMPF ?»	horse-ERG say-ENT : « what happened-PERF », say-ENT , « more-FOC head hang.AOC-AOR that », say-ENT , « what happened-PERF , what attention-PL-IMPF ?»
