predicted_glosses	glosses
when IPFV-CN be.young-1SG.II when IPFV-CN be.young-1SG.II DEM LOC come.over-T REL live-PR.IPFV INS Gitsegyukla	still IPFV-CN small-little-1SG.II still small-little-1SG.II time COMP-CN toward come-CN PART relative PREP-OBL-CN LOC-CN Gitsegyukla
PROG-1PL.II live-1PL.II LOC-on.heart.PL-1PL.II COMP house-PL-3.I POS-3.I mom dad	still IPFV-CN live-1PL.II LOC-CN in house-PN mother-1PL.II PCNJ father-1PL.II
CCNJ come-over-1SG Man call-PASS-3 Man CCNJ come-over-1SG Jacob Brown	CCNJ toward come-PN Man-CN name-3.II Man toward arrive Jacob Brown
CCNJ want-3 PROSP tell-3 story about when PRF-3 hunt-3	CCNJ want-3.II PROSP-3.I tell-T-CN MANR LVB-3.II COMP IPFV-CN hunt-ANTIP-3.II
CCNJ INCEP PROSP go-CN 3.III-CCNJ make-CN	CCNJ INCEP IPFV PROSP away go-3.II
CCNJ again-3SG.II collect-3SG.II everything-ACC PROSP use-INF so PROSP catch-3SG.II what PROG hunt-3SG.II	CCNJ-3.I take.PL-CN all 3.III-CN CNT.AMT-CN PROSP use-TR-3.II PROSP MANR CIRC.PSBL hunt-ANTIP-3.II
CCNJ want-3SG.II FUT-1PL.IO tell-CN MANN-3SG.II PROSP do-CN	CCNJ want-3.II PROSP-3.I tell-T-3.II OBL-1PL.II MANR LVB-3.II
CCNJ make-CAUS-3PL sit-down-INCL '1PL.EXCL, sit-down-CAUS-3SG '1SG.II C-PL brother-PL sister-PL	CCNJ-3.I sit.PL-T-1PL.II sit-T-TR-3.II 1PL.III 1SG.III PCNJ-CN PL-sibling-PASS-1SG.II
CCNJ INCEP INDEF time say-3SG.II FUT tell-FUT-1SG DM-PROX 2PL .	CCNJ on COMP say-3.II PROSP tell-T-TR-1SG.II PN-DEM.PROX OBL-2SG.II
IPFV-CN go.hunt-1SG.II-PROSP CCNJ there exist-CN grouse-SG.OBL CCNJ INS-way exist-CN grouse-SG.OBL he-say-PAST	IPFV-CN go-1SG.II PROSP hunt-ANTIP-1SG.II CCNJ sit-CN grouse block.way sit-CN grouse QUOT.3SG 3.III
CCNJ NEG see-CN moose-SG	CCNJ 1.I see-CN moose
PROG eat-CN PROSP want-1SG.II OBL-1SG.II INS-for-rest-CN village-3.II	IPFV-CN want-1SG.II PROSP 1.I eat-CAUS2-CN contain-village.people-1SG.II
CCNJ COND move-TR-1SG.II CCNJ say-3SG.M	CCNJ IRR-SPT move-PASS-1SG.II QUOT.3SG
PROSP CCNJ FOC-3.II fly.away-3.II PROSP CCNJ FOC-3.II run.away-3.II want-1SG.II _ want-1SG	PROSP CCNJ fly-CN grouse PROSP CCNJ flee.PL-CN moose want-1SG.II
CCNJ on NEG make-3SG.II sound Man	CCNJ on COMP NEG-FOC SUPER-make.noise-PASS-PN Man
sit-TR-3 still look-TR-3 2PL.II look-TR-3 COMP-CN do-1PL.II look-TR-3 COMP-CN be-1PL.II	keep.on sit 3.III see-3.II 1PL.III see-3.II MANR make-T-TR-1PL.II see-3.II MANR LVB-1SG.II
CCNJ and what he do-TR-3SG ask-TR-1PL	CCNJ-1.I 1PL.I ask what-CN LVB-3.II
What shoot-PAST-2SG grouse or moose	what-CN CONTR shoot-TR-2SG.II grouse IRR DWID moose
CCNJ then sit-PFV-3SG	CCNJ on COMP sit-3.II
"CCNJ say-3SG.II ""if 1SG.II shoot-CN grouse,"""	CCNJ say-3.II IRR-SPT 1.I shoot grouse
if IPFV-1SG shoot grouse CCNJ 1SG.II only eat-FUT.1SG.II CCNJ alone	IRR-SPT 1.I shoot grouse PROSP CCNJ only one.HUM 1SG.III PROSP eat-PASS-SX
CCNJ if IPFV-CN wait-1SG.II until PROSP walk.away-3 grouse-3.SG.OBL CONJ-3.OBL	CCNJ IRR-SPT wait-ANTIP-1SG.II completely PROSP NMLZ away go-CN grouse
PROSP=1SG go-CN CONT=3.II close-CN moose-PL then=3 VER able-PASS-1SG.II walk-TR-1SG.II close-CN CONT=3.II	PROSP CCNJ-1.I CIRC.PSBL PROSP toward go LOC-CN little-ATTR toward close-CAUS2-ANTIP-1SG.II LOC-CN moose
PROSP CONJ be.able-FUT-1SG shoot-FUT-1SG PROSP CCNJ all people eat-FUT	PROSP CCNJ-1.I CIRC.PSBL PROSP 1.I shoot-3.II PROSP CCNJ eat.PL-PASS-CN all 3.III-CN people
CCNJ on finish-TR-3 tell-TR-3 1PL.II CCNJ go.home-TR-3	CCNJ on COMP finish-PASS-3.I tell-T-3.II OBL-1PL.II CCNJ leave go.home-3.II
CCNJ INCEP two day after that again see-1SG.II REFL-3SG.M-OBL DEM	CCNJ INCEP two day finish-SX away leave-SX time COMP-CN 1.I just-again see-3.II
CCNJ toward PROG-run-1SG.II CCNJ 1SG PROSP say-1SG.II	CCNJ toward run-1SG.II LOC-3.II CCNJ on COMP say-1SG.II OBL-3.II
can-2SG.II say-2SG.II what happen-3SG.II about grouse-3SG.II Q	NEG-2.I CIRC.PSBL PROSP-2.I tell-T-CN MANR LVB-CN grouse PR.EVID
CCNJ then tell-PFV-3SG PN win het CCNJ PROSP go-PFV-1SG PN-POSS mother house-POSS-2SG CCNJ tell-FUT-1SG PN-DAT	CCNJ on COMP say-3.II PROSP toward arrive 1SG.III LOC-CN house-PN mother-2SG.II PROSP CCNJ-1.I tell-T-3.II OBL-2SG.II
CCNJ go-1SG home wait-1SG.II for him then tell-3SG.II about grouse	CCNJ back go.home-1SG.II CCNJ 1.I wait-ANTIP-1SG.II OBL-3.II CCNJ-3.I tell-T-CN MANR LVB-CN grouse
CCNJ PROG-tell-3.II CCNJ 1.I-CCNJ say-3.II	CCNJ IPFV-3.I tell-T-3.II CCNJ on COMP say-3.II
hunt-PROSP CONJ want-1PL.II get-INF moose	IPFV-CN hunt-ANTIP-1SG.II CCNJ want-1PL.II PREP-OBL-CN moose
CCNJ want-1PL-PROSP feed-TR-1PL all people CCNJ but grouse LOC path-CN .	CCNJ want-1PL.II PROSP eat-CAUS2 all 3.III-CN people CCNJ block.way sit-CN grouse
CCNJ if move-CN PROSP CCNJ fly-CN.PASS grouse	CCNJ IRR-SPT move-PASS-1SG.II PROSP CCNJ fly grouse
CCNJ 1.I-CCNJ say-3SG Man start-3SG.III fly-CN and make-3SG.III sound betl'a-REDUP PROSP only thus	CCNJ on COMP say-PN Man flap flap flap flap QUOT.3SG PROSP MANR fly-CN grouse
"""as soon as move-1SG.II CN break-CN word-PASS-1SG.II"" CCNJ ""as soon as move-1SG.II CN break-CN word-PASS-1SG.II CN stick"	true on COMP move-PASS-1SG.II QUOT.3SG true on COMP move-PASS-1SG.II break-CAUS2-1SG.II-CN stick
CCNJ noisy-CN when grouse-PL fly-PL-CN CCNJ CCNJ hear-able-2SG.II them when fly-PL-CN CCNJ CN: betl'a betl'a betl'a betl'a betl'.	CCNJ noisy-CN COMP-FOC-3.I fly.PL-CN grouse CCNJ on COMP fly-3PL.II CCNJ-2.I hear-3.II flap flap flap flap flap
CCNJ NEG want-1SG.II PROSP move-1SG.II CONJ NEG INCEP run-away-3SG.F.O moose NEG-DEM.DIST grouse exist-3SG.F.O	CCNJ NEG-FOC want-1SG.II PROSP NMLZ move-PASS-1SG.II PROSP MANR flee.PL-CN moose hunt-ANTIP-1SG.II COMP block.way sit-CN grouse
"every-time see-CN 1SG Man Jacob Brown CCNJ 1SG ask him say-CN ""FUT-2SG tell-INF PL.OBL story about betl'a betl'?"""	COMP-1.I HAB see-PN Man Jacob Brown CCNJ 1.I again ask-3.II NEG-2.I CIRC.PSBL PROSP-2.I tell-T-CN MANR LVB-CN flap flap OBL-1PL.II-Q
CCNJ 1.I-CCNJ CNTR-then name-TR-3SG.III Man call-DIR-1SG Betl'a Betl'	CCNJ on COMP CAUS1-sit-DETR-ATTR CAUS1-name-T-TR-1SG.II-DM Man Betl'a Betl'
that CONJ CONC-CN man-PL continually-MANR-3.I on call-1SG.II Betl'a Betl'	on REAS COMP-CN name-1SG.II now PREP-PN Betl'a Betl'
that-enough say-1SG.II	CNT.AMT-CN say-1SG.II
