predicted_glosses	glosses
when young-BE 1.SG.II-COM come-OBL-3.II.REL when come-OBL-3.II.REL FOC=3 live-BE Gitsegyukla-IN REL.REL.PROX house-LOC stay always-BE below down-BE Gijigyukwhl.loc-LOC	still IPFV-CN small-little-1SG.II still small-little-1SG.II time COMP-CN toward come-CN PART relative PREP-OBL-CN LOC-CN Gitsegyukla
when young our.relative come-OBV.3s-IRR when come-OBV.3s our.relative-FOC in Gitsegyukla to live there help-PREP and_Gitsegyukla	still IPFV-CN small-little-1SG.II still small-little-1SG.II time COMP-CN toward come-CN PART relative PREP-OBL-CN LOC-CN Gitsegyukla
house-LOC OBL-father-FOC=3 OBL-mother-FOC=3 OBL-location stay-1PL.II prevail-IPFV=EPIS=CN  we.parentNode-INCEP OBL.1PL house-GEN.ResponseEntity-In evolving-IPFV our	still IPFV-CN live-1PL.II LOC-CN in house-PN mother-1PL.II PCNJ father-1PL.II
stay still house.our mom-AND-dad at live-FOC=3.PL.II OBL after DEM.PROX live-FOC=1PL.II	still IPFV-CN live-1PL.II LOC-CN in house-PN mother-1PL.II PCNJ father-1PL.II
and man call-3.SG.MAN place-LOC Man man call-3.SG.MAN Jacob Brown	CCNJ toward come-PN Man-CN name-3.II Man toward arrive Jacob Brown
and come-INC Man called Person foc=3 Person come-INC Jacob Brown	CCNJ toward come-PN Man-CN name-3.II Man toward arrive Jacob Brown
3SG.II want-3SG.I story-3SG.I tell-PROSP-3 when hunt-3SG.I tale-INST tell-PASS-3SG.III	CCNJ want-3.II PROSP-3.I tell-T-CN MANR LVB-3.II COMP IPFV-CN hunt-ANTIP-3.II
3SG.II want-PROG story tell when hunt-PASS-AUX time tale-FOC	CCNJ want-3.II PROSP-3.I tell-T-CN MANR LVB-3.II COMP IPFV-CN hunt-ANTIP-3.II
and before third.person proximal go-INCEP	CCNJ INCEP IPFV PROSP away go-3.II
and before he go-SPT -SPT -SPT -SPT	CCNJ INCEP IPFV PROSP away go-3.II
and-3SG.II gather-TR all indeed-FOC=3 use in.order.to hunt-TR prevail-PROSP=3 hunt so accumulate-PROSP=3_SURPASS-OBJ.3SG.LXW_PREVENT-PART	CCNJ-3.I take.PL-CN all 3.III-CN CNT.AMT-CN PROSP use-TR-3.II PROSP MANR CIRC.PSBL hunt-ANTIP-3.II
and gather-3SG everything INFIN-hunt-LOC so INFIN-catch-3SG.PROSP.INAN REFL.INAN. use-INF all conj-PROSP-future must-3SG.INAN pursue.all-manifest-IPFV.	CCNJ-3.I take.PL-CN all 3.III-CN CNT.AMT-CN PROSP use-TR-3.II PROSP MANR CIRC.PSBL hunt-ANTIP-3.II
and tell-3.II want-3.I-3.II 1PL.II-OBL how do-3.III do-3.III-3.II	CCNJ want-3.II PROSP-3.I tell-T-3.II OBL-1PL.II MANR LVB-3.II
and want tell-INC us how do would-inf	CCNJ want-3.II PROSP-3.I tell-T-3.II OBL-1PL.II MANR LVB-3.II
and-3SG.II PST-make-1PL.II sit.down-CAUS2-OBL 1SG.INCL.(-FOC=3) sibling-PL sibling-PL-sit-3.II.	CCNJ-3.I sit.PL-T-1PL.II sit-T-TR-3.II 1PL.III 1SG.III PCNJ-CN PL-sibling-PASS-1SG.II
and sit-SPT 1PL.II-OBL/FOC=3, sit-SPT 1SG.I=CN/OBL, 1SG and sibling.PL.INDP-LOC sit-ITER-many-T/OBL	CCNJ-3.I sit.PL-T-1PL.II sit-T-TR-3.II 1PL.III 1SG.III PCNJ-CN PL-sibling-PASS-1SG.II
and then tell 3.I-FUT-EPIS=CN 2SG this.NMLZ-say	CCNJ on COMP say-3.II PROSP tell-T-TR-1SG.II PN-DEM.PROX OBL-2SG.II
and then 3.I man-R say-IRR FOC=1 tell-DISTR you this	CCNJ on COMP say-3.II PROSP tell-T-TR-1SG.II PN-DEM.PROX OBL-2SG.II
go-PROSP 1SG.I-hunt OBL grouse-be.in.the.way.2SG.OBL-PROSP DEM grouse-be.in.the.way.3 OBL say he	IPFV-CN go-1SG.II PROSP hunt-ANTIP-1SG.II CCNJ sit-CN grouse block.way sit-CN grouse QUOT.3SG 3.III
HUNT PST-1SG go-IPFV-EPIS-CN grouse FOC=3 be.INDP-PST-3 CN grouse FOC=3 be.INDP-PST-3 say.3SG	IPFV-CN go-1SG.II PROSP hunt-ANTIP-1SG.II CCNJ sit-CN grouse block.way sit-CN grouse QUOT.3SG 3.III
and 1.SG. see-PAST moose	CCNJ 1.I see-CN moose
and DEM.PROX see-PST-1SG moose	CCNJ 1.I see-CN moose
want-1SG.I feed-IMPF-IRR village POSS-1SG.OBJ	IPFV-CN want-1SG.II PROSP 1.I eat-CAUS2-CN contain-village.people-1SG.II
want PST-1SG.II CAUS2-feed-INF 1SG.POSS village	IPFV-CN want-1SG.II PROSP 1.I eat-CAUS2-CN contain-village.people-1SG.II
and if-INC move-1SG-INC say	CCNJ IRR-SPT move-PASS-1SG.II QUOT.3SG
1.SG. CAUS1 move-FOC-QUOT and he.said	CCNJ IRR-SPT move-PASS-1SG.II QUOT.3SG
ART grouse-WILL.fly-PAST far-FOC ART moose-WILL.run-PAST that-FOC 1SG.N desire-3SG.III	PROSP CCNJ fly-CN grouse PROSP CCNJ flee.PL-CN moose want-1SG.II
the grouse would fly.away ANTE- and the moose that I want would run.away .	PROSP CCNJ fly-CN grouse PROSP CCNJ flee.PL-CN moose want-1SG.II
and NEG-FOC=3 make-IPFV-EPI-CN man	CCNJ on COMP NEG-FOC SUPER-make.noise-PASS-PN Man
and NEG=FOC=3 make sound Man	CCNJ on COMP NEG-FOC SUPER-make.noise-PASS-PN Man
sit PR.EVID 3SG.II- look.at-PROSP=3=CN 1PL.II- look.at-PROSP=3=CN do PR.EVID PROSP=3.PL.I- look.at-PROSP=3=CN do how-3.III	keep.on sit 3.III see-3.II 1PL.III see-3.II MANR make-T-TR-1PL.II see-3.II MANR LVB-1SG.II
sit INCEP still-3.SG look 1PL.II OBL look PROSP=3 CAUS2-do 1PL.II look PROSP=3 PROSP=3.	keep.on sit 3.III see-3.II 1PL.III see-3.II MANR make-T-TR-1PL.II see-3.II MANR LVB-1SG.II
CONNN-SPT ask what 3.III-FOC=3 do-PST	CCNJ-1.I 1PL.I ask what-CN LVB-3.II
AND 1PL.II ASK what 3.III do	CCNJ-1.I 1PL.I ask what-CN LVB-3.II
INTERROG-PST shoot-2SG what-GROUP.PRT grouse or moose-FOC.3SG	what-CN CONTR shoot-TR-2SG.II grouse IRR DWID moose
shoot grouse-OR-moose Q 2SG.EVID.INDQ-say	what-CN CONTR shoot-TR-2SG.II grouse IRR DWID moose
and then 3SG.II sit-PAST	CCNJ on COMP sit-3.II
CN and then sit down	CCNJ on COMP sit-3.II
and 3.SG.II-say PROSP=1.SG.I shoot grouse-FOC	CCNJ say-3.II IRR-SPT 1.I shoot grouse
and PROG say- INCEP DET man- OBL shoot- FUT grouse- OBL.	CCNJ say-3.II IRR-SPT 1.I shoot grouse
INCEP-SG ANTL-IRR shoot grouse only me-FOC eat-FUT-3SG.III	IRR-SPT 1.I shoot grouse PROSP CCNJ only one.HUM 1SG.III PROSP eat-PASS-SX
INCEP PR.EVID grouse shoot FUT=3 , only 1.SG.= 3SG.II eat=CN FUT be alone 3.II.	IRR-SPT 1.I shoot grouse PROSP CCNJ only one.HUM 1SG.III PROSP eat-PASS-SX
and then-COND wait-OBL='III grouse walk until from me AN leave-IRR happen.	CCNJ IRR-SPT wait-ANTIP-1SG.II completely PROSP NMLZ away go-CN grouse
and if wait-EPIS=CN until walk ground.partridge away be-situated-PRS-FUT.	CCNJ IRR-SPT wait-ANTIP-1SG.II completely PROSP NMLZ away go-CN grouse
then 1SG.I-FUT be_able_to walk right there CAUS2-get_closer moose to PRT come_close to	PROSP CCNJ-1.I CIRC.PSBL PROSP toward go LOC-CN little-ATTR toward close-CAUS2-ANTIP-1SG.II LOC-CN moose
then DIM able-to-walk.right then close=FOC=3 reach CAUS2 be.able.to -PL moose close be.able.to_SURFADIUS	PROSP CCNJ-1.I CIRC.PSBL PROSP toward go LOC-CN little-ATTR toward close-CAUS2-ANTIP-1SG.II LOC-CN moose
and then-FOC=1 I-FUT=3 indeed-then all OBL-person-PL and then CAUS2-eat-FUT eat-PROSP=3 all	PROSP CCNJ-1.I CIRC.PSBL PROSP 1.I shoot-3.II PROSP CCNJ eat.PL-PASS-CN all 3.III-CN people
and then able-FOC=1 shoot CAUS2 3SG.II - and then all person.PL.INCL eat will	PROSP CCNJ-1.I CIRC.PSBL PROSP 1.I shoot-3.II PROSP CCNJ eat.PL-PASS-CN all 3.III-CN people
after 3SG.II finish-tell-IPFV=EPIS=CN 1PL.II-go-IPFV=EPIS=CN home-go	CCNJ on COMP finish-PASS-3.I tell-T-3.II OBL-1PL.II CCNJ leave go.home-3.II
incep 1SG tell finish-CAUS2 1PL.II go-OBL home_PARSER after 3.III	CCNJ on COMP finish-PASS-3.I tell-T-3.II OBL-1PL.II CCNJ leave go.home-3.II
and then day two-after two-oblique after again see-1SGFOC 3SG.OBJ	CCNJ INCEP two day finish-SX away leave-SX time COMP-CN 1.I just-again see-3.II
and then after two day-PL after-AD again see 1.SG.OBJ him.	CCNJ INCEP two day finish-SX away leave-SX time COMP-CN 1.I just-again see-3.II
and run-EPIS=CN 1SG.I towards he-INS say-EPIS=CN 3.II	CCNJ toward run-1SG.II LOC-3.II CCNJ on COMP say-1SG.II OBL-3.II
and run-1SG.SG toward-3.SG.INDP say-PAST-1SG.SG to-3.SG.INDP him	CCNJ toward run-1SG.II LOC-3.II CCNJ on COMP say-1SG.II OBL-3.II
know-EPIS what-OBL happen-3.INDP grouse-OBL about can you-QPART	NEG-2.I CIRC.PSBL PROSP-2.I tell-T-CN MANR LVB-CN grouse PR.EVID
NEEMA da'ak̲hlxw DIMA MEHLIHL WILA WIHL BISDE'YG i ?	NEG-2.I CIRC.PSBL PROSP-2.I tell-T-CN MANR LVB-CN grouse PR.EVID
and then SPT say 1SG.NOM=FUT=1SG.D T=PN mother-POSS house-OBL 1SG.NOM=FOC=3 tell-FUT-S 2SG-OBL	CCNJ on COMP say-3.II PROSP toward arrive 1SG.III LOC-CN house-PN mother-2SG.II PROSP CCNJ-1.I tell-T-3.II OBL-2SG.II
AND then say-\textsc{3sg} \textsc{1sg}=be.at.(-\textsc{fut)} \textsc{2sg.poss} mom house and \textsc{1sg} \textsc{future} talk to.(\textsc{dir})	CCNJ on COMP say-3.II PROSP toward arrive 1SG.III LOC-CN house-PN mother-2SG.II PROSP CCNJ-1.I tell-T-3.II OBL-2SG.II
and arrive OBL-1.SG II and then OBL-3 tell-PROSP-3 about grouse DEM.PROX	CCNJ back go.home-1SG.II CCNJ 1.I wait-ANTIP-1SG.II OBL-3.II CCNJ-3.I tell-T-CN MANR LVB-CN grouse
and arrive PR.EVID-1SG home and wait-PR.EVID=1SG him, and then tell-PR.EVID FOC=1SG.INDP about grouse	CCNJ back go.home-1SG.II CCNJ 1.I wait-ANTIP-1SG.II OBL-3.II CCNJ-3.I tell-T-CN MANR LVB-CN grouse
and tell-INC man-3SG-EPIS and 3SG say PST.	CCNJ IPFV-3.I tell-T-3.II CCNJ on COMP say-3.II
and tell-CONT.PST story , and then say-3SG.II	CCNJ IPFV-3.I tell-T-3.II CCNJ on COMP say-3.II
hunt-PST moose-OBL-WITH 1PL.II want-FUT-PST moose+A/FOC=1PL.II indeed	IPFV-CN hunt-ANTIP-1SG.II CCNJ want-1PL.II PREP-OBL-CN moose
hunt-PROG 1SG.II want-FOC=1 1PL.II moose get	IPFV-CN hunt-ANTIP-1SG.II CCNJ want-1PL.II PREP-OBL-CN moose
and want-1PL.II DEM.PROX all person-PL.IN walk-PROSP feed=FUT=1PL.II but bird DEM there-LOC hindered-3SG.II	CCNJ want-1PL.II PROSP eat-CAUS2 all 3.III-CN people CCNJ block.way sit-CN grouse
and want-FOC=1.PL all person-PL feed-CAUS2=CN, but grouse way-INSTR be-3.SG.III.	CCNJ want-1PL.II PROSP eat-CAUS2 all 3.III-CN people CCNJ block.way sit-CN grouse
if 1SG-move-INC grouse would-fly	CCNJ IRR-SPT move-PASS-1SG.II PROSP CCNJ fly grouse
1.SG. IRR move-IF grouse-FOC fly-PASS.	CCNJ IRR-SPT move-PASS-1SG.II PROSP CCNJ fly grouse
man say INCEP grouse CAUS2-fly and sound betl'a betl'a betl'a betl'a betl' make -PST.	CCNJ on COMP say-PN Man flap flap flap flap QUOT.3SG PROSP MANR fly-CN grouse
man SPT say INCEP grouse, betl'a-betl'a-betl'a-betl'a-betl'a, PROG fly-and sound make-s	CCNJ on COMP say-PN Man flap flap flap flap QUOT.3SG PROSP MANR fly-CN grouse
asp soon say move-INC-3SG when asp soon say move-INC-3SG break-TR-3SG-OBJ stick	true on COMP move-PASS-1SG.II QUOT.3SG true on COMP move-PASS-1SG.II break-CAUS2-1SG.II-CN stick
SIM 'NII WIN HLENTXWI'Y - diya - SIM 'NII WIN HLENTXWI'Y - KW'ESINI'YHL G̲AN .	true on COMP move-PASS-1SG.II QUOT.3SG true on COMP move-PASS-1SG.II break-CAUS2-1SG.II-CN stick
INCEP noisy-ADV fly-3.INCP grouse-OBL hear-3.OBL-PROSP fly-3.INCP also it-FOC=3 hear=3.OBL-PROSP also repeated five times.	CCNJ noisy-CN COMP-FOC-3.I fly.PL-CN grouse CCNJ on COMP fly-3PL.II CCNJ-2.I hear-3.II flap flap flap flap flap
1.SG.II noisily fly-INC grouse when-LOC hear-PROG fly-3.III then then then then then.	CCNJ noisy-CN COMP-FOC-3.I fly.PL-CN grouse CCNJ on COMP fly-3PL.II CCNJ-2.I hear-3.II flap flap flap flap flap
so NEG=FOC want-1SG.II move-DES not ADV grouse be.there-INS not run-FUT moose-(OBL) because.of CS they be.there-FOC	CCNJ NEG-FOC want-1SG.II PROSP NMLZ move-PASS-1SG.II PROSP MANR flee.PL-CN moose hunt-ANTIP-1SG.II COMP block.way sit-CN grouse
so need-NEG.1SG want-IRR I-FOC move-FOC not ADV grouse DEM.PROX be-IRR there ADV moose-FOC (my) game CS run.away-FUT-NEG to.	CCNJ NEG-FOC want-1SG.II PROSP NMLZ move-PASS-1SG.II PROSP MANR flee.PL-CN moose hunt-ANTIP-1SG.II COMP block.way sit-CN grouse
every-time man ask-1SG.II Man Jacob Brown and OBL see-OBL 1SG.I-him PROSP=3 story REAS 1.SG.=-PL tell-CAUS=PN betl'a betl' FOC=3-REFL-Ques	COMP-1.I HAB see-PN Man Jacob Brown CCNJ 1.I again ask-3.II NEG-2.I CIRC.PSBL PROSP-2.I tell-T-CN MANR LVB-CN flap flap OBL-1PL.II-Q
"every time see 1SG - MAN , Jacob Brown , II ask him , ""tell us story about betl'a betl' ?"""	COMP-1.I HAB see-PN Man Jacob Brown CCNJ 1.I again ask-3.II NEG-2.I CIRC.PSBL PROSP-2.I tell-T-CN MANR LVB-CN flap flap OBL-1PL.II-Q
DEM.PROX COP FOC=3 PROSP=3.INDP-say-NMLZ-FUT NAME Ablaut NAME	CCNJ on COMP CAUS1-sit-DETR-ATTR CAUS1-name-T-TR-1SG.II-DM Man Betl'a Betl'
DEM.PROX COP INCEP PROG-name-3.I DEM.NOM Man Betl'a Betl'	CCNJ on COMP CAUS1-sit-DETR-ATTR CAUS1-name-T-TR-1SG.II-DM Man Betl'a Betl'
dem.prox why name-1SG now 1SG.NOM Betl'a Betl'a	on REAS COMP-CN name-1SG.II now PREP-PN Betl'a Betl'
DEM.PROX=CN why 1.SG.= name now Betl'a Betl'	on REAS COMP-CN name-1SG.II now PREP-PN Betl'a Betl'
DEM.PROX=FOC VERB=CN OBL=SBJ-1.SG. 	CNT.AMT-CN say-1SG.II
that-CIRC.NECESS as-AX much as-FOC 1.SG.I= say-VER.	CNT.AMT-CN say-1SG.II
