predicted_glosses	glosses
CONJ MID-say-bz(PDIR.YON).o(3MINI) doctor fox SUBR , “ be.3PLI-already dry towel come.3PLI .”	but MID-say-PDIR.YON doctor.med SUBR , “ body-1AUGII CAUS-dry-COS-1AUGI towel PCLF.HAND-1AUGII .”
so.then PFV RL-take-DPV-GDIR.IN-1PLINCL-3MINIA five letter PL be-DPV-vowel in language Natqgu now namely DEM.PROX here c q r x z	so.then PFV RL-take-COS-NMLZ.POSS letter.note those five RL-be-COS vowel GEN1A Natqgu time DEM2.PROΧ , krlc-3MINII here-PL : cqrxz .
be.foreign-PCLF.B&G-3AUGII REL be.big write-PDIR.HITHER SUBR-be.schooled GEN1A there DAT.be.schooled PCLF.B&G-3AUGII DAT.live-CONC.INCLUS and name priest Tomson , be.Australian .	foreigner DEM2.DIST IRR-be SUBR-be.big GEN1A school RL.3AUG-be-3AUGIS ᴄᴏᴍ.ᴘʟ name-3MINII priest Tomson , TPNYM Australia .
and Daniel also-make a book of word REL be.one which REL English REL name , book name REL Natqgu	and Daniel work-APPL-3MINII also book GEN1A word DEM2.DIST RL.PAS-MID-say-PDIR.YON PREP English SUBR dictionary , book dictionary GEN1A Natqgu .
chapter DEM2.DIST nine	chapter DEM2.DIST nine
just-stay-PDIR.HITHER-1PLU there at camp four week PEL, DEM3.PROX word bishop Baddeley RL-go-3SG.M that MID-say-3MINIA IRR-travel-PDIR.YON-1AUGI DEM3.PROX there at Malaita .	be-TR-INTS-just-1AUGI place.DEM2.DIST PREP camp week four , and word bishop Baddeley DEM2.DIST RL-go-COS-PDIR.YON-3MINIS SUBR IRR-travel-PDIR.YON-1AUGI DAT.3MINII place.DEM2.DIST Malaita .
push-RL-INTS-REFL-PDIR.YON-1AUGI and crawl-GDIR.OUT-THRU-1AUGI DEM3.DIST corner , stand.UP-INTS-1AUGI and be.1AUGII DEM3.DIST RL-rush-GDIR.UP-COS PREP small hill and DEM3.DIST be.3SG.PRES RL-rest-INTS-COS-1AUGI .	push-INTS-REFL-PDIR.YON-1AUGI and crawl-go.through-GDIR.OUT-1AUGI corner.3D DEM2.DIST , stand.up-PDIR.HITHER-1AUGII and be.1AUGII DEM2.DIST RL-hurry-GDIR.UP-COS PREP a mountain SUBR-be.small and be.1AUGII DEM2.DIST RL-rest-COS .
03 . about-THEM.DIST grow.up-POSS.1SG.SG and statue-PL demon-GEN	03 . PREP NMLZ1-be.big-COS-NMLZ.POSS-1MINII and image demon-PL
DEM2.PROX-GEN2 RL-allow-2PL.QST-2SG.PREP 1PL-enter-GDIR.INTS.YON.1AUGI-2PL.PREP PREP ship so that DEM3.PROX pull-GDIR.OUT-3SG.PREP 1PL-GEN1 boat QST	if allow-APPL-mq(PDIR.HITHER).q(2MINI) NMLZ1-enter-NMLZ.POSS-PDIR.YON-1AUGI PREP ship PCLF.HAND-2MINII and IRR-drag-PDIR.YON-3MINIA boat PCLF.HAND-1AUGII ?”
SUBR hit.water-GDIR.AWAY-bz(PDIR.HITHER).o(1MINI)-3MINIIP , PFV RL-go-GDIR.IN-COS PREP ship , SUBJ CAPTAIN PFV say-3MINIIP-1MINI DEM1.DIST first have.to-TEST-1MINI-3PLU	SUBR paddle-GDIR.OUT-bz(PDIR.YON).o(1MINI) DEM2.DIST PREP ship , PFV RL-said-COS captain SUBR IRR-test-first-PDIR.YON-3AUGIA be.1MINII .
fish needle.small Metalo look.up-ᴘᴀʀᴛ follow-ᴘᴀʀᴛ go.up-ᴘᴀʀᴛ and watch also hang-ᴘᴀʀᴛ up there	PFV RL-look.at-follow-GDIR.UP-COS Metalo NMLZ1-go-GDIR.UP-NMLZ.POSS-3MINII , and watch-PDIR.YON needlefish that.one be.small hang-DSTR-GDIR.UP-COS-also-PDIR.YON .
Ruth Incne TOP return-GDIR.IN PREP school CONJ one another teach-PL-1EXCL.INCL there	Ruth Incne SUBR return-PDIR.HITHER-3MINIA DEM2.DIST PREP school PFV RL-teach-COS-1AUGI COM.DU .
DEM vowel during PREP time PCLF.B&G Rik Biukan , REL DEM vowel during NMLZ1-top-NMLZ.POSS REL	vowel these PREP time PCLF.B&G Rik Biukan , head vowel these PAS-spotted-GDIR.DOWN .
name June Iteti replace name Annie Sade PREP 3SF.POSS be.a.typist-FUT of 1PL	and June Iteti exchange-3MINIA Annie Sunday PREP NMLZ1-become-NMLZ.POSS-3MINII typist PCLF.RSBL-1AUGII .
SUBR stay-RL-one-year-3MINII DEM2.DIST , RL-take-3MINII leader PREP school SUBR DEM.DIST-take SUBJ.3MINI-inside house PREP DEM.DIST year 1941	SUBR reach-bz(PDIR.YON).o(1MINI) DEM2.DIST year SUBR-be.one , PFV RL-take-COS SUBR-be.big GEN1A school be.1MINII PREP NMLZ1-work-NMLZ.POSS-1MINII PREP insides house PCLF.B&G-3MINII PREP year 1941 .
request-COS-1SG.ACT-1OBJ.3POSS him three time , but NEG-give-COS-3MINII-PL all	ask.for-GDIR.IN-APPL-bz(PDIR.YON).o(1MINI)-3MINIA DAT.3MINII time-3MINII three , but NEG-allow-APPL-PDIR.HITHER-3MINIA-NEG all .
house PL-go-PAST	house finish-INTS-GDIR.DOWN-also-3MINIS .
SUBR see-1MINI SUBR that.CONJ none SUBR CAUS-return-PDIR.HITHER-3MINIA word-1MINII-1MINI , when SUBR good spirit-ERG SUBR speak-3MINIIP-3MINIA that.CONJ think-1MINIIP-1MINI become .	SUBR none DEM2.DIST child SUBR see-1MINI and SUBR CAUS-return-PDIR.HITHER-3MINIA word-1MINII , PFV RL-CAUS-take-COS mind-1MINII SUBR spirit good this RL-speak-PDIR.HITHER DAT.1MINII .
CONJ-MID say-3MINII CAPT SUBR , “ NEG-go-PURP be.1AUGII DAT transport-INCH be.1AUGII DAT be.3MINII NEG DAT-go-PURP be.1AUGII doctor GEN work CONJ .”	but MID-say-PDIR.YON captain SUBR , “ NEG-travel-APPL-PDIR.HITHER-1MINI-NEG here NMLZ1-travel-DPV-INTS-NMLZ.POSS-1MINII be.2MINII PREP NMLZ1-work-NMLZ.POSS-2MINII but travel-APPL-PDIR.HITHER-1MINI NMLZ1-work-NMLZ.POSS doctor.med .”
and PFV RL-say-COS for.3PAG-follow-INF-COM 3PAG.POSS own think-COM .	and PFV RL-say-COS-PDIR.HITHER-3MINIA NMLZ1-go-follow-COS-NMLZ.POSS-3MINII place.DEM2.DIST RL-shoot neck-1AUGII .
1SG.ERG alone make-TR-3SNIS all that.which 1PL.INCL see-PR.IND-1PLINCL in world this LOC1 : tree , grass , vine , animal , bird , fish , thing small that fly-PR.IND-3SNIS and that crawl-PR.IND-3SNIS .	be.3MINII only SUBR MID-work-APPL thing all these RL-see-TR-12AUGI-PL PREP world : tree , grass , rope , animal , bird , fish , thing SUBR-3AUG-be.small SUBR 3AUG-fly-DSTR-3AUGIS and SUBR 3AUG-crawl-DSTR-3AUGIS .
then one-day DAT.SG-day DAT.SG-day and MID-say-PDIR.YON DAT.3MINII DAT.SG-leader REL DAT.PL-brother say-PDIR.YON-3MINIA DAT.SG-Mz.leader DAT.SG-village REL Ncnqmz SUBR “ just ask-DIR.YON DAT.3MINII DAT.SG-Mzdealwx Q DEM.SG want-PRF-3MSING DAT.1PL try-INF something DAT.1PL have-PRF-1PL or not ”	so.then a day , SUBR-be.big GEN1A monk MID-say-PDIR.YON-3MINIA PREP Mwekati leader GEN1A village Ncnqmz.vil , SUBR , “ say-PDIR.YON just PREP Mzdealwx , if want mind-3MINII NMLZ1-try-NMLZ.POSS-PDIR.YON-1AUGI a thing SUBR stay-PDIR.HITHER-3MINIS DAT.1AUGII or no ?”
RPRN2-DEM1.DIST-3MINII-PL class 1 and class 2 .	RPRN2-DEM1.DIST-3MINII-PL class 1 and 2 .
doctor fox SUBR turn-path-PDIR.HITHER-3MINIA DEM2.DIST behind PREP hand-3MINII SUBR give-NMLZ.POSS-PDIR.HITHER-1MINI umbrella COS-cover-from.rain-APPL-bz(PDIR.YON).o(1MINI) bag PCLF.HAND-3MINII DEM2.DIST RL-carry-GDIR.UP-1MINI neck-3MINII , side head-3MINII SUBR-left.side PFV RL-bang-GDIR.IN-COS PREP a place crooked SUBR-bow-GDIR.OUT-PDIR.HITHER PREP tree coconut DEM2.DIST SUBR-bend-GDIR.OUT-PDIP.HITHER PREP road	Dckta Foks SUBR turn-path-PDIR.HITHER-3MINIA DEM2.DIST hand , because IRR-give-PDIR.HITHER-3MINIA umbrella SUBR IRR-CAUS-cover.from.rain-APPL-bz(PDIR.YON).o(1MINI) basket PCLF.HAND-3MINII DEM2.DIST RL-live-1MINI , side head-3MINII SUBR-left.side PFV RL-bang-GDIR.IN-COS place bent GEN1A a tree coconut SUBR bow-GDIR.OUT-m PREP road .
and crew DEM happy also BE-PAST , because go-CONT-go.with-PAST-1AUGI ᴄᴏᴍ.ᴘʟ ᴘʀᴇᴘ work-ᴘᴜʀᴘ ᴘʀᴇᴘ garden , build-ᴘᴜʀᴘ house , hunt-ᴘᴜʀᴘ ᴘʀᴇᴘ dog , trap-ᴘᴜʀᴘ bird , fish-ᴘᴜʀᴘ ᴘʀᴇᴘ sea , dance-PAST-1AUGI ᴄᴏᴍ.ᴘʟ ᴘʀᴇᴘ dance-place .	and crew PCLF.RSBL-3AUGII-PL 3AUG-be.happy-also-3AUGIS , because go-always-1AUGI ᴄᴏᴍ.ᴘʟ PREP NMLZ1-work-NMLZ PREP garden , NMLZ1-work-NMLZ house , NMLZ1-MID-go-DPV-NMLZ dog , NMLZ1-lure.fowl-NMLZ chicken , NMLZ1-fish-NMLZ sea and dance-1AUGI ᴄᴏᴍ.ᴘʟ PREP dance.ring .
1PL.INCL-be.1AUGII MID-still-live-PAUC-PFV there two.ten-one 1PL.INCL be.1AUGII	be.1AUGII SUBR 3AUG-live-INTS-COS-just ten-two-1AUGII nrade two .
then today in morning , 1SG-wash 1SG-face well , 1SG-wear 1SGRLX-clothing REL day REL Sade and PFV RL-go-COS house PCLF.B&G-3MINII .	so.then today PREP morning , wash-INTS-GDIR.OUT-1MINI eye-1MINII , wear.clothing-INTS-1MINII cloth GEN1A Sunday and PFV RL-go-COS-bz(PDIR.YON).o(1MINI) house PCLF.B&G-3MINII .
be.many-only four man REL guard-PL-PAST PREP camp our	mankind four-just SUBR 3AUG-watch-3AUGIS PREP camp PCLF.B&G-1AUGII .
"PFV RL-MID-say-GDIR.DOWN-PDIR.YON-3MINIA 1MINID, "" be.happy-RL-CONT-1SG be.located-RL-APPL-LOC here work-APPL-LOC ?"""	"PFV RL-MID-say-COS-PDIR.HITHER-3MINIA SUBR , "" be.happy-about-2MINI NMLZ1-work-PROP here ?"""
mother Leslie and group four student NEG wait-3ᴘʟ ᴘᴏ.ᴘʟ go-ᴘᴇʀ ᴅᴏᴡɴ water drink	priest Lesile be.3ᴀᴜɢII ᴄᴏᴍ.ᴘʟ child those four NEG-NMLZ1-wait-3AUGIA-NEG friend-3AUGII those RL.3AUG-go-GDIR.DOWN-3AUGIS PREP water PREP NMLZ1-drink-NMLZ.POSS-3AUGII .
be DEM2.DIST be.powerful MID holy self-surpass NEG.see NEG be.able-MID carve NEG DEM3.PROX image	Be.god be.3MINII mankind SUBR powerful , holy , CAUS-surpass REFL , NEG-PAS-see-NEG and none SUBR IRR-MID-carve.wood image-3MINII .
book DEM1.DIST-3MINII-3AUGIS be.3ᴀᴜɢII they.here , book of REL Later.Holy.Writings REL Kc.Ate , book of REL Nzangiongr , and book of REL Nabzkxtr .	book those be.3ᴀᴜɢII they.here , book GEN1A holy.writings DEM2.DIST afterward-3MINIS , book GEN1A NMLZ1-worship-NMLZ , and book GEN1A song-SUBR-holy .
chapter DEM2.DIST six	chapter DEM2.DIST six
exist-PL-3DIST sea GEN1S-3DIST bird and bush , and exist-PL-3DIST NEG sea GEN1S-3DIST bird and sea GEN1S-3DIST fish and bush GEN1S-3DIST animal and .	stay-GDIR.UP-also-PDIR.YON-3MINIS bird GEN1A sea and bush , and stay-GDIR.UP-also-PDIR.YON-3MINIS tree GEN1A sea and animal GEN1A bush .
but even time DEM2.PROX still-new-PLU-3PLUP	but reach-PDIR.HITHER-3MINIA time DEM2.PROΧ PFV RL.3AUG-new-still-3AUGIS .
witness-PFV-1SG.ANT that during that time work-NMLZ-REL church-POSS and companion-PL go-PFV-3PL-DIST very-good	NMLZ1-see-NMLZ.POSS-1MINII-3MINIA time those NMLZ1-work-NMLZ.POSS church.building and companions go-really-INTS .
begin-work PREP month January 1949 .	begin-GDIR.IN-1MINI NMLZ1-work-NMLZ PREP January 1949 .
stay-INTS-PDIR.YON-1AUGI Tantalau week three and then be.1AUGII go-PDIR.YON-1AUGI with Bishop down sea and stay-INTS-PDIR.YON-1AUGI in village name Fiu	be-TR-INTS-just-1AUGI Tangtalau week three and be.1AUGII ᴄᴏᴍ.ᴘʟ bishop DEM2.DIST RL-go-GDIR.DOWN-COS-1AUGI sea RL-be-COS-1AUGI PREP a village name-3MINII Fiu.vil .
but say-PFV COS-1AUGIA DAT come-CAUS-IMPER-APPL-3MINIS COS-1AUGII be.1AUGII , PFV COS-3MINIS-come-APPL-3MINIS COS-1AUGII in midst DEM-GEN-PL person-PL	but MID-say-PDIR.YON-1AUGI DAT.3MINII IRR-go-DPV-PDIR.YON-3MINIA be.1AUGII , PFV RL-go-DPV-GDIR.IN-COS-PDIR.YON-3MINIA be.1AUGII PREP midst people those .
group DEM2.DIST PREP father Leslie ERG-go-GDIR.OUT and INV-flat descend-GDIR.IN-3PLU	group-3MINII DEM2.DIST PREP priest Lesile 3AUG-go-3AUGIS and PFV RL.3AUG-go-GDIR.DOWN-COS-3AUGIS place flat .
3PL run 3PL-throw.down-REFL-APPL-3PL time base DEM2.PROX cross DEM2.DIST	3AUG-hurry-GDIR.IN-3AUGIS 3AUG-throw-GDIR.DOWN-REFL-3AUGIS PREP base cross DEM2.DIST .
PREP back.part-3MINII , TOPIC-RL.3AUG-call-3MINII some-of-US-APPL RL.3AUG-believe-APPL-3AUGII CONJ we-EXCLUSIVE PFV go-and-join-with-3AUGII them-APPL in-pray-APPL-3AUGIS for Mzdealwx .	PREP back.part-3MINII , SUBR-be.big GEN1A monk those call.someone-3MINIA AT.ΦNT.PL be.1AUGII those RL.3AUG-MID-obey-3AUGIS , go-PDIR.YON-1AUGI PFV RL-enter.in-COS-PDIR.YON-1AUGI ᴄᴏᴍ.ᴘʟ PREP NMLZ1-pray-NMLZ-PDIR.YON PREP Mzdealwx .
"MID-say-PDIR.HITHER-3MINIA leader father willie SUBR , "" DEM-want 3AUG-go-INF go-3AUGII , go-3AUGII , CONJ 1MINII DEM-be.1SG-INF stay-1SGII here ."""	"MID-say-PDIR.HITHER SUBR-be.big GEN1A-1AUGII priest Wili SUBR , "" who 3AUG-want neck-3AUGII NMLZ1-go-APPL , IRR-go-3AUGIS , but be.1MINII IRR-be-INTS-PDIR.HITHER-1MINI here ."""
1PL-work-APPL PREP school COM money 1PL-work-BEN like	NMLZ1-work-much-NMLZ.POSS-1AUGII PREP school , be.like-1AUGI mankind SUBR 3AUG-serve-3AUGIS money .
CONJ then say-PAST-1SG.EXCL.NOM Father 1SG.INCL.DAT be.1EXCL.NOM Anglican and be.1INCL.NOM Catholic when pray-1EXCL.NOM church-LOC morning-TEMP and evening-TEMP also pray-2INCL.NOM here-LOC house-LOC sleep-2INCL.NOM .	"PFV RL-said-COS priest DAT.1AUGII SUBR , "" be.2AUGII Anglican and be.1AUGII Catholic , time DEM2.DIST RL-pray-APPL-1AUGII PREP church.building PREP morning and evening , pray-also-2AUGI house DEM2.PROΧ RL-sleep-APPL-2AUGI ."
and RL-shut-TR 1SAI.POSS eye tight	and eye-1MINII CAUS-sleep-INTS-GDIR.IN-just-1MIN.CMB .
so.then PFV go-o(3NPRO) k(LOC) Nzlvz(PNP) .	so.then PFV RL-travel-COS-3MINIS also Reef.Is .
and PFV RL-motor-COS away.from Aijz-ABL float-CAUS-PFV-PCL.3F&G-leave-PCLF.3F&G-3AUGIS	and PFV RL.3AUG-travel-away.from-COS-3AUGIA Aijz RL-float-GDIR.IN-COS-PDIR.YON far .
and PFV 1SG-jump-MNR-QCK-DN-IN-sea	and jump-fast-INTS-GDIR.DOWN-1MINI sea .
DEM1.PROX manioc field also DEM2.DIST pineapple DEM1.PROX-RL-plant-GDIR.IN therein exist.3PL	field manioc DEM2.DIST PAS-plant-TR also those therein pineapple .
24 . MZDEALWX confess-APPL-PDIR.HITHER-3MSING GOD	24 . Mzdealwx confess-3MINIA NMLZ1-believe-NMLZ.POSS-3MINII god
give.thanks-INTS-PDIR.YON-1AUGI PREP God and be.1AUGII DEM2.DIST RL-peel-INTS-1AUGI and RL-eat-INTS-1AUGI .	thank-INTS-APPL-PDIR.YON-1AUGI PREP god , and be.1AUGII DEM2.DIST RL-MID-peel-COS-1AUGI and RL-eat-COS-1AUGI .
1PL want-PAST book these four finish-PASS-INTS same time-LOC .	want neck-1AUGII book these four NMLZ1-finished-NMLZ.POSS-PDIR.YON-3AUGIA time SUBR-be.one .
house there stand-3SNG PREP side GEN1A river DEM2.DIST	house there stand-INTS-GDIR.OUT PREP side GEN1A river .
1EXCL-begin-1EXCL school PREP moon October PREP year 1943	begin-GDIR.IN-1AUGI NMLZ1-be.schooled-NMLZ PREP moon October 1943 .
SUBR think-PDIR.HITHER-1MINI-3MINIIP , PFV RL-manager-COS SOCIETY , Jason Melzk , PFV RL-leave-INF-1SGIP-3SGIR .	SUBR think-TR mind-1MINII NMLZ1-MID-dream-NMLZ.POSS-1MINII DEM2.DIST , PFV RL-ask.for-GDIR.IN-COS-bz(PDIR.YON).o(1MINI) PREP manager GEN1A Society , Jason Melzk , NMLZ1-go-GDIR.OUT-NMLZ.POSS-1MINII .
so.then be.1MINII DEM2.DIST RL-come-COS-1MINI on ship	so.then be.1MINII DEM2.DIST RL-work-COS-1MINI PREP ship .
work-POSS.1SG.FUT of exchange Scriptures POSS.3SG.FUT into Natqgu DEM very big, ask-PFV 1SG from Sanders that finish-FUT.1SG be-FUT.1SG peacemaker	NMLZ1-work-NMLZ.POSS-1MINII PREP NMLZ1-MID-exchange-NMLZ Nzryrngrkxtr PREP Natqgu SUBR be.big-much-3MINIA DEM2.DIST , PFV RL-ask.for-COS-bz(PDIR.YON).o(1MINI) PREP Sadas IRR-finished-NMLZ.POSS-1MINII PREP NMLZ1-become-NMLZ.POSS-1MINII peacemaker .
ART-two-3AUGII DEM 3AUG-four-3AUGIS .	PCLF.RSBL-3AUGII MID-two-APPL-3AUGII child 3AUG-four-3AUGIS .
rope PCLF.ASSOC-3MINII be-GDIR.UP-PDIR.ABOVE roof house PREP fishhook REL and needlefish be bait fishhook PCLF.ASSOC-3MINII .	"rope PCLF.ASSOC fish.hook PCLF.HAND-3MINII PFV RL-lying.down-GDIR.DOWN-PDIR.HITHER there wq PREP back.part house , and be bait GEN1A fish.hook PCLF.HAND-3MINII needlefish ."""
PRO-PL talk-about-RL.PL therein and PRO-PL be.RL in.agreement-RL.PL that PRO-PL should leave-INTS village-POSS.PL	3AUG-speak-GDIR.IN-3AUGIS therein and mind-3AUGII be.one-TR SUBR IRR-leave-COS-3AUGIA village PCLF.B&G-3AUGII .
school DEM1.DIST be.schooled-only-DUR.PAST daytime in but NEG1 sleep-there-DUR.PAST and child be-mixed-3PLU boy and girl	school DEM1.DIST IRR-be.schooled-INTS-APPL-just child daylight , but NEG-IRR-sleep-NEG therein , and child IRR-mix-3AUGIS , child mankind and child female .
we-1AUG travel-PAST Veranaso and arrive-PAST from Fiu , Tzngarare and Tzlede there be-PAST , NEG start-PAST yet school-BEN .	travel-PDIR.YON-1AUGI Veranaaso friend-1AUGII those Fiu.vil , Tzngarare and Tzlede PFV RL.3AUG-be-COS-3AUGIS therein , but NEG-3AUG-be.schooled-not.yet-3AUGIS .
see-PFV.o(3MINII) bring-PROG tree branch-ACC.SG DAT.3MINII cry-PFV.o(1MINI) say-PFV.MID.o(PDIR.YON).o(1MINI) DAT.3MINII “ father-VOC go-PFV.ELAT.PL we-INCL PREP door-ACC.SG because NEG-tell-PFV.o(3MINIS) POSS.2SG door-ACC.SG be.PFV-PROG.HITHER forbid-PASS.INCORP-LOC enter-INF there-LOC .	SUBR see-PDIR.HITHER-1MINI NMLZ1-take-NMLZ.POSS-PDIR.HITHER-3MINIA branch tree DEM2.DIST , be.1MINII DEM2.DIST RL-cry-COS-1MINI and RL-MID-say-COS-bz(PDIR.YON).o(1MINI) DAT.3MINII SUBR , “ father , jump-GDIR.IN-1AUGI PREP doorway DEM2.DIST because NEG-say-PDIR.HITHER-2MINI-NEG DAT.1AUGII SUBR doorway DEM2.DIST PAS-restrict-APPL NMLZ1-jump-GDIR.IN-NMLZ.POSS-1AUGII therein .”
PREP back.part-3MINII COM know-TR-3AUGII NMLZ1-leader-POSS-3AUGII about image demon REL hand-APPL-3AUGII CAUS-break-TR-1AUGPL and REL run-go.through-APPL-TR-3AUGPL lie.down-RL.PL-APPL-TR-3AUGPL and NMLZ1-food.parcel-GEN1A PCLF.DRINK-DUAL abandon-TR-1AUGII COM speak-APPL-3AUGPL PREP COS-1AUGPL about REL .	PREP back.part-3MINII , SUBR 3AUG-know-TR SUBR-3AUG-be.big GEN1A-1AUGII-PL image demon DEM2.DIST PCLF.DRINK-3MINII RL-CAUS-broken.stick.like.obj-PDIR.YON-1AUGI and RPRN2.DEM4.PL RL-jump-go.through-1AUGI-PL RL.3AUG-lying.down-TR-together-3AUGIS , and NMLZ1-food.parcel-NMLZ hog.plum.fruit those two RL-jump-away.from-1AUGI , PFV RL.3AUG-speak-APPL-COS-PDIR.HITHER-3AUGIA DAT.1AUGII .
say-GDIR.OUT-PAS Mama Leslie that one-of them-ERG climb-INF , but NEG-just-PAS because all too-weak-FUT	PFV RL-MID-say-COS-PDIR.YON priest Lesile SUBR IRR-climb INDF.SG be.3ᴀᴜɢII , but none because 3AUG-weak-together-3AUGIS .
time DEM1.DIST write-PAUC 1AUG head spotted with diacritic-PL write-RL-APPL-1PL .	time DEM1.DIST MID-write-1AUGI PREP vowel DEM2.DIST CMPL RL.3AUG-spotted-GDIR.DOWN head-3MINII .
place many DEM1.PROX-meet-APPL group people SUBR NMLZ1-work NMLZ1-people PREP road	place many SUBR meet-APPL-1AUGII group people SUBR 3AUG-work-3AUGIS PREP road .
and time there-just rain-hard-RL.3SG wind that lightning and thunder 1PL-also hear-PFV-1PLIS siren one blow-PFV-3SGIS .	and time there-just RL-fall-much-APPL rain , wind , lightning and thunder , hear-PDIR.YON-1AUGI whistle cry-COS also .
want-1MINII 3DEMII.POSS-GEN see-PASTII 1MINII-POSS that and must-1PLUII hear-INFII 3DEMII .”	want mind-1MINII IRR-tell-TR-PDIR.HITHER-3MINIA thing-DEM2.DIST see-1MINI DAT.12AUGII and IRR-listen-PDIR.YON-12AUGI DAT.3MINII .”
but ART-man only kill-APPL-PL-3ANIM-FUT people REL see-PASS-PL-3ANIM-PRF	but mankind MID-kill-COS-3MINIS people SUBR PAS-see-INTS-just .
1SG-shine-PAST flashlight down into pool small in sand DEM.DIST beach .	CAUS-MID-shine-INTS-GDIR.DOWN-bz(PDIR.YON).o(1MINI) torchlight DEM2.DIST PREP a pool SUBR-be.small-INTS PREP insides sand .
village PCLF.B&G-1AUGII Narnztilolx.vil that.one village DEM2.PROX be.very.good-INTS-3SG and be.beautiful-INTS-3SG .	village PCLF.B&G-1AUGII Narnztilolx.vil , village DEM2.DIST extremely.good and eye-3MINII clear .
DEM2.PROX-walk DEM2.PROX for DEM2.PROX-ambush NEG have.ceased-3AUG until today and CONT go.on-3AUG	NMLZ1-walk-NMLZ there PREP war-hidden NEG-stop-COS-NEG reach-PDIR.HITHER-3MINIA time DEM2.PROΧ and PCLF.HAND RL-go-still .
time ORD-two REL brother PL-ABS again go-PAST-time-PL CONJ I, with go-PAST-PL-with 1PL .	PREP time-3MINII ORD-two SUBR 3AUG-go.out-APPL again monk , enter.in-bz(PDIR.YON).o(1MINI) ᴄᴏᴍ.ᴘʟ PREP NMLZ1-go-NMLZ.POSS-3AUGII .
doctor and captain GEN-live GEN1A-3AUGII PREP Nea , 3AUG-happy-be.CAUS-PAS-3AUGII PREP 1AUG-leader those 3AUG-continue-GDIR.OUT-INTS-3AUGIS PREP 1AUG-converse-INTS-3AUGOS ᴄᴏᴍ.ᴘʟ .	NMLZ1-be-NMLZ.POSS doctor.med and captain Nea.vil , 3AUG-be.happy-about-3AUGIA because SUBR-3AUG-be.big GEN1A-1AUGII-PL 3AUG-go-always-PDIR.YON-3AUGIS DAT.3AUGII PREP NMLZ1-tell-NMLZ.POSS-3AUGII ᴄᴏᴍ.ᴘʟ .
48 . letter.note second SUBR PAS-write-PDIR.YON PREP mountain Tzlede CONJ go-PDIR.YON Tzngarare	48 . letter.note ORD-two SUBR PAS-write-PDIR.YON PREP mountain Tzlede and NMLZ1-go-APPL Tzngarare
2AUG-tell-PDIR.REM John SUBR , “ child-big your those tell-INF me about-LAT yet NEG-know 1AUG , NEG-speak 1AUG with-LAT yet , NEG-travel 3AUG with-LAT yet .	said-again-PDIR.YON John SUBR , “ son-2MINII DEM1.PROΧ-PL be.big RL-say-mq(PDIR.HITHER).q(2MINI) DAT.1MINII NEG-know-not.yet-1AUGI be.3ᴀᴜɢII , NEG-speak-not.yet-1AUGI ᴄᴏᴍ.ᴘʟ and NEG-walk-not.yet-1AUGI ᴄᴏᴍ.ᴘʟ .
krlc that - tqpi-ngrbole say-1.SBJ.SG.PRES , REL CLF CLF nakqletxpwz bad thing REL CLF trka happen da only prtz him	RPRN2-DEM1.DIST RL-say-APPL-bz(PDIR.YON).o(1MINI)-3MINIA , SUBR name SUBR IRR-call-only be.3MINII DEM1.DIST only.one PREP thing bad SUBR happen .
PRO-DAT tell.PAST-1SG PRO-ABS that go.FUT-1SG-up-in bush	PFV RL-MID-say-COS-bz(PDIR.YON).o(1MINI) DAT.3MINII SUBR IRR-go-GDIR.UP-bz(PDIR.YON).o(1MINI) bush .
but NEG-allow-APPL-PDIR.HITHER-3MINIA-NEG .	but NEG-allow-APPL-PDIR.HITHER-3MINIA-NEG .
work-HABITUAL year eight be.employed PREP peace-maker-APPL	work-1MINI year eight PREP NMLZ1-become-NMLZ.POSS-1MINII peacemaker .
SUBR none DEM2.DIST person DEM3.DIST Japan SUBR find-again-3PLU , PFV go-along-3PLU road REL go-to-3SG village Maravovo	SUBR none DEM2.DIST TPNYM Japan SUBR 3AUG-see-3AUGII PREP school , PFV RL.3AUG-go-along-COS-3AUGIA road DEM2.DIST RL-go-path-3MINIA village Maravovo .
PFV-baptise-GDIR.OUT-1PLU outside PREP side house POSS brother-PLU .	baptised-1AUGI outside PREP house PCLF.B&G monk .
SUBR-be.big RL-school-GDIR.DOWN , priest Sevenoclock , RL-go.with-TR-PDIR.YON-3MINIA DEM2.DIST PREP dormitory empty SUBR DEM1.DIST NMLZ1-be.empty-NMLZ.POSS-1AUGII .	SUBR-be.big GEN1A school DEM2.DIST , priest Sevenoklok , go-DPV-GDIR.IN-3MINIA be.1AUGII PREP a house GEN1A NMLZ1-sleep-NMLZ SUBR be.empty-3MINIS .
so.then PFV do-NPST-1SGI DEM2.PROX be.3SGII bad so.that leave-DESID-1SG	so.then PFV RL-do-COS-1MINI DEM2.DIST thing SUBR NEG-be.good-NEG SUBR IRR-leave-APPL-1MINII .
and.then be.1AUGII DEM2.PROX-want-1AUGII-COS DEM2.DIST-cry-ABL-1AUGII	and be.1AUGII IRR-die-COS-APPL-1AUGII crying .
but NEG-mourn-APPL-too.much we because encourage PDIR.THITHER-3PLUPA-PA-NOM lord be.the.one 1PLUPA-ACC	but NEG-mourn-INTS-much-1AUGI because leader DEM2.DIST RL-CAUS-hot-GDIR.IN-PDIR.HITHER-3MINIA neck-1AUGII .
GEN3-house PL uproot-PAST-3PLIS completely all out	house GEN1A-3MINII-PL pull.out-INTS-GDIR.OUT-them sea all .
so.then one.more person-declare himself , and six be.difficult very because fear-1PL very much lr Japan .	so.then declare-REFL again DEM2.DIST be.one , and SUBR six PFV RL-be.difficult-INTS-COS because fear-TR-much-1AUGI lr Japan .
"hear-APPL-1SG MONICA MID-say-DAT.1SG.DIR SUBR , "" father , Q DEM.DIST Jesus REL 2SG-call-APPL-2SG.DIST time.when 1SG-cry-APPL-1SG ?"""	"hear-bz(PDIR.YON).o(1MINI) Mcnika MID-say-COS-PDIR.HITHER-3MINIA DAT.1MINII SUBR , "" dadi , where Jesus DEM2.DIST RL-call.someone-2MINI today time DEM2.DIST RL-cry-APPL-1MINII ?"""
ADV every SUN day name-DOC FOX come LOC here PREP celebrate holy-communion-REL , bring-only-3SGIS person with 3SG	always PREP Sunday those RL-go-APPL-PDIR.HITHER doctor.med Fox here PREP NMLZ1-CAUS-eat-SUBR-holy-NMLZ.POSS-3MINII , RL-MID-go-DPV-just-PDIR.HITHER-3MINIS person SUBR-be.one .
PREP go-down.along-river.move DEM2.DIST , SUBR-be.big GEN1A-1PLII shoot three Japan NUMCL-three	PREP NMLZ1-go-along-GDIR.DOWN-NMLZ.POSS-1AUGII DEM2.DIST water , SUBR-be.big GEN1A-1AUGII shoot-PDIR.YON-3MINIA Japan three .
chapter DEM2.DIST three	chapter DEM2.DIST three
Joseph ERG hospital in REST.RL.3SAG ERG PREP work PFV tell.PST-PFP 1MINI DAT Joseph POSS work	Joseph SUBR lying.down-3MINIA DEM2.DIST PREP hospital PFV RL-MID-say-COS-PDIR.HITHER captain DAT.1MINII IRR-take-COS-also-1MINI NMLZ1-work-NMLZ.POSS Joseph .
OK(MRLZ) and PFV RL-return-COS-again-PDIR.YON-3AUGIS .	be.good PFV RL.3AUG-return-COS-again-PDIR.HITHER-3AUGIS .
but all fear-APPL-1INCL.PLU be.PAST-1INCL.PLU .	but fear-1AUGI all APPL-1AUGII .
brother ERG DEM2.DIST and break-RL-APPL-3MINII into two equal pieces	take.hold.of-TR-PDIR.YON monk DEM2.DIST break-INTS-3MINII piece-3MINII two equal-APPL .
gather.together-APPL-CONV-bz(PDIR.YON).o(1INCL) with DAT.3AUGII at house-POSS.1INCL	gather-together-1AUGI house PCLF.B&G-1AUGII ᴄᴏᴍ.ᴘʟ .
