predicted_glosses	glosses
k'ay yukwhl guts'uusgi'y , k'ay guts'uusgi'y dis wihl hog-win kw'itxwhl hla gu'm aloohl , g̲a'ahl Gi-ji-gyukwh-la-'a .	still IPFV-CN small-little-1SG.II still small-little-1SG.II time COMP-CN toward come-CN PART relative PREP-OBL-CN LOC-CN Gitsegyukla
k'ay- UK- y-ukwhl jog'o'm g'a'ahl ts'im wilps nox'o'm g'an nigwoodi'm .	still IPFV-CN live-1PL.II LOC-CN in house-PN mother-1PL.II PCNJ father-1PL.II
Ii hogwin kw'itxws Manhl wat , Man , hogwin kw'itxw Jacob Brown .	CCNJ toward come-PN Man-CN name-3.II Man toward arrive Jacob Brown
Ii hasak̲t dim-t mehlihl wi-la wi-lt wi-n yukwhl silinasxwt .	CCNJ want-3.II PROSP-3.I tell-T-CN MANR LVB-3.II COMP IPFV-CN hunt-ANTIP-3.II
Ii hlaa-3s yukw DIM saa YEET ,	CCNJ INCEP IPFV PROSP away go-3.II
iit do-OKHL walk'a 'nithl g̲abi-i-HL dim hoo-yit, dim wi-la da'-AKHLXW silinasxwt .	CCNJ-3.I take.PL-CN all 3.III-CN CNT.AMT-CN PROSP use-TR-3.II PROSP MANR CIRC.PSBL hunt-ANTIP-3.II
Ii ha-sak̲t dim-t meh-lit loo = m wi-la wilt .	CCNJ want-3.II PROSP-3.I tell-T-3.II OBL-1PL.II MANR LVB-3.II
iit WENDI-m, t'aatdit 'NUU-m, 'nii'y g̲anhl GASDI-K-g̲asi-K-wsi'y .	CCNJ-3.I sit.PL-T-1PL.II sit-T-TR-3.II 1PL.III 1SG.III PCNJ-CN PL-sibling-PASS-1SG.II
"Ii 'nii win-het , ""Dim mehldi'-y tun loon ."""	CCNJ on COMP say-3.II PROSP tell-T-TR-1SG.II PN-DEM.PROX OBL-2SG.II
"""Yukwhl yee'y dim silinasxwi'y , ii t'aahl-bisde'y , sg̲a t'aahl-bisde'y ,"" diye 'nit ."	IPFV-CN go-1SG.II PROSP hunt-ANTIP-1SG.II CCNJ sit-CN grouse block.way sit-CN grouse QUOT.3SG 3.III
Ii NA GYA'AHL x̲adaa .	CCNJ 1.I see-CN moose
Yukwhl has-a-g̲a'y dim an tx̲oog̲anhl g̲alts'eb-i'y .	IPFV-CN want-1SG.II PROSP 1.I eat-CAUS2-CN contain-village.people-1SG.II
"""and- if i- move FUTURE-INDICATIVE ,"" he- said ,"	CCNJ IRR-SPT move-PASS-1SG.II QUOT.3SG
dim ii gi-pay-kwhl bisde'y dim ii huu-thl x̲adaa ha-sa-g̲a'y 	PROSP CCNJ fly-CN grouse PROSP CCNJ flee.PL-CN moose want-1SG.II
Ii 'nii win need-ii x̲sdeltxw-s MAN -3	CCNJ on COMP NEG-FOC SUPER-make.noise-PASS-PN Man
disim t'aa 'nit , GYA'A- t 'nuu-m , GYA'A- t wila jep-di'm , GYA'A- t wila wili-'y .	keep.on sit 3.III see-3.II 1PL.III see-3.II MANR make-T-TR-1PL.II see-3.II MANR LVB-1SG.II
iin dip gi-da-x̲ guhl wilt .	CCNJ-1.I 1PL.I ask what-CN LVB-3.II
Guhl g̲ay guxwin bisde'y -what shoot.PFV-1sg.PASS-IND ji ligi x̲adaa or grouse moose	what-CN CONTR shoot-TR-2SG.II grouse IRR DWID moose
ii 'nii WIN -t'aat ,	CCNJ on COMP sit-3.II
"Ii het: ""jida na-guxw-bisde'y,"""	CCNJ say-3.II IRR-SPT 1.I shoot grouse
Jida na- guxw- bisde'y , dim- ii- k'am- ky'ulhl= 'nii'y= dim= yook̲xwit= .	IRR-SPT 1.I shoot grouse PROSP CCNJ only one.HUM 1SG.III PROSP eat-PASS-SX
"""Ii JIDA GI-BEE'ESXWI'Y WAAY=T DIM AN SUWI YEEHL BISDE'Y ,"""	CCNJ IRR-SPT wait-ANTIP-1SG.II completely PROSP NMLZ away go-CN grouse
dim iin da'ak̲hlxw dim hogwin yee GA-'hl , TS'UUS-i- hogwin dul-binsxwi'-y GA-'hl X̲ADA-' .	PROSP CCNJ-1.I CIRC.PSBL PROSP toward go LOC-CN little-ATTR toward close-CAUS2-ANTIP-1SG.II LOC-CN moose
Dim iin da'ak̲hlxw dim an GUXWT-HL, dim ii TX̲OOK̲XWHL walk̲'a 'NIHL GYET-HL.	PROSP CCNJ-1.I CIRC.PSBL PROSP 1.I shoot-3.II PROSP CCNJ eat.PL-PASS-CN all 3.III-CN people
Ii 'nii win HLISXWT-MEHLIT loom-HL ii daa'whl HA'WT-HL .	CCNJ on COMP finish-PASS-3.I tell-T-3.II OBL-1PL.II CCNJ leave go.home-3.II
Ii hlaa gilbil sa HLI-sit saa DAA'-whlit dis WIHL na HEKSI-mox̲ GYA'AT .	CCNJ INCEP two day finish-SX away leave-SX time COMP-CN 1.I just-again see-3.II
Ii hog-win bax̲a'y g̲o'ot , ii 'nii win he'y loot: and I- ERG run- PST toward him , and I say- PST to him	CCNJ toward run-1SG.II LOC-3.II CCNJ on COMP say-1SG.II OBL-3.II
"""Nee- MA DA-'A: KXLW DI- MA MEHLIHL WI- LA WIHL BI- SDE'Y- G I ?"""	NEG-2.I CIRC.PSBL PROSP-2.I tell-T-CN MANR LVB-CN grouse PR.EVID
"Ii 'nii win het , ""DIM hog-win KW'ITXW 'nii-y G̲A'AHL wilps NOX̲ON , dim iin meh-lit LOON ."""	CCNJ on COMP say-3.II PROSP toward arrive 1SG.III LOC-CN house-PN mother-2SG.II PROSP CCNJ-1.I tell-T-3.II OBL-2SG.II
Ii GUKWS ha'wi'y ii na GIBEE-'esxwi'y LOOT , iit MEHLIHL WILA WIHL BISDE-'y .	CCNJ back go.home-1SG.II CCNJ 1.I wait-ANTIP-1SG.II OBL-3.II CCNJ-3.I tell-T-CN MANR LVB-CN grouse
and- PFV tell story- ERG and- then say- PFV 3⟩- 3rd	CCNJ IPFV-3.I tell-T-3.II CCNJ on COMP say-3.II
Yuk-whl silinasxwi'y ii ha-sa-g̲a-'m a-loohl x̲adaa	IPFV-CN hunt-ANTIP-1SG.II CCNJ want-1PL.II PREP-OBL-CN moose
"""Ii HASAGA-'M dim TXOOGAN walk'a 'nihl gyet , ii sga T'AAHL bisde'y ."""	CCNJ want-1PL.II PROSP eat-CAUS2 all 3.III-CN people CCNJ block.way sit-CN grouse
Ii JIDA HLEN-TXWI'-Y DIM Ii GIPAYKW BIS-DE'-Y	CCNJ IRR-SPT move-PASS-1SG.II PROSP CCNJ fly grouse
Ii 'nii win hes MAN, betl'a-betl'a-betl'a-betl', DIYA, dim WILA gipaykwhl BISDE'Y.	CCNJ on COMP say-PN Man flap flap flap flap QUOT.3SG PROSP MANR fly-CN grouse
"""As-soon-as move-PAST-CONTR-1SG say-PAST-3SG, ""as-soon-as move-PAST-CONTR-1SG say-PAST-3SG, break-PAST-3SG stick-OBL-SG."""	true on COMP move-PASS-1SG.II QUOT.3SG true on COMP move-PASS-1SG.II break-CAUS2-1SG.II-CN stick
"""Ii ts'eek̲-xwhl windiit liipay-kwhl bisde'y , ii 'nii win gi-pay-kwdiit iima x̲a'nit: betl'a betl'a betl'a betl'a betl'."" || ""It's IMPF-noisy when grouse-PL fly IMPF-noise make-PL , and you can hear them when they fly: betl'a betl'a betl'a betl'a betl'."" || ""It's noisy when the grouse flies, and when they fly you can hear it: betl'a betl'a betl'a betl'a betl'."""	CCNJ noisy-CN COMP-FOC-3.I fly.PL-CN grouse CCNJ on COMP fly-3PL.II CCNJ-2.I hear-3.II flap flap flap flap flap
Ii NEEDII HASAG̲A'Y dim an HLENTXWI'Y dim WILA huuthl X̲ADAA, SIILINASXWI'Y, win sg̲a t'aaHL BISDE'Y .	CCNJ NEG-FOC want-1SG.II PROSP NMLZ move-PASS-1SG.II PROSP MANR flee.PL-CN moose hunt-ANTIP-1SG.II COMP block.way sit-CN grouse
"Wina k'uxw gya'as Man , Jacob Brown , ii na hox̲ ASK.HIM , ""Neem da'ak̲hlxw STORY that old again betl'a betl' SEE-US-INCL again"""	COMP-1.I HAB see-PN Man Jacob Brown CCNJ 1.I again ask-3.II NEG-2.I CIRC.PSBL PROSP-2.I tell-T-CN MANR LVB-CN flap flap OBL-1PL.II-Q
Ii 'nii win sit-aa-'mam siwe-t-di'yt Man Betl'a-X Betl'-X	CCNJ on COMP CAUS1-sit-DETR-ATTR CAUS1-name-T-TR-1SG.II-DM Man Betl'a Betl'
'Nii g̲an WIHL-u we'y GYU'N-a-s ASP Betl'a Betl'	on REAS COMP-CN name-1SG.II now PREP-PN Betl'a Betl'
g̲abiihl- HE-say-thus	CNT.AMT-CN say-1SG.II
