predicted_glosses	glosses
"""I"", say-SBSS, ""among person-PL in middle go.PTP, this-DIR maybe fate-DAT look.INF ."""	« 1sg.abs », say-AOR , « go-AOR man-ERG-GEN between-INESS enter.FUT-FUT , look.HORT maybe 1sg.gen fate-INESS cop .»
the-one-NESS decision be-3PL .	agreement-PL one was .
but we-FOC need return-INF DAT group-ERG come-IMP-PL let's-go-back-DIR	« And.but 1pl.abs them-ERG-GEN to returned-AOR want-ENT , come group happened-AOR go.back.HORT 1pl.abs .»
love-ABS be-what Q	love what was , ashuq boy ?
why where 3SG exist-Q	what-DAT , where be-AOR ?
many good toast-PL say-PTP-PFV-DECL , everybody event about happy-AOR be-PST-PFV-3PL .	good toasts-PL say-AOR , agreements-PL be-AOR , 1pl.abs event.from-OBL-SUPER-EL agree remain-AOR .
and Chukotka-ERG cold place-ABS be-AOR , I-ERG say-AOR	well Chukotka cold place was , cold place was .
( Natavan )	( Natavan ).
"""young man-OBL call and take"" said-IMPF, ""bride-OBL for.yourself take"" said-IMPF, ""bride-OBL not fitting is-PRF"" said-IMPF."	they-ERG « call.IMPV that boy » say-ENT , « they 2sg-DAT take.IMPV » say-ENT , « they he-DAT worthy cop.NEG ».
"then and guy-SBST said ""well everything-SBST happened-PTP father punished-PTP and other punished-PTP but mother and two brother still other province-LOC in are-PRES"""	then this boy-ERG say-ENT that , « but now all happened-PERF », say-ENT , « grandfather-DIR-FOC punishment take-AOR , others.and-ERG-FOC punishment take-AOR , but ,» say-AOR , « other.one province.in-INESS 1sg.gen mother-FOC still.be,.remain » say-AOR , « three brother-FOC still.be,.remain , two brother-FOC still.be,.remain » say-AOR .
"""pour-OPT it-ABS on king-DAT and say dog-INF or pig-INF be-SUB-OPT-you-DAT"""	« this pouring.AOC-AOR that,.the.same king-DIR-GEN over-SPSS-INELAT say.IMP that » say-ENT , « 2sg-SBSS-EL or dog be.will-AOP , or pig be.will-AOP ».
he-ERG again courtyard-DAT go-PST-ENT	more-FOC go-AOR himself yard.in-INESS-SPSS .
"this-PL person-PL too "" punish-INF will-be-done "" say-PST-ENT"	they.to.also punishment order.IMPV » say-AOR .
twenty three-MSD soldier-PL-ABS out-of eight nation-PL was , russian-PL much nation-PL was .	Twenty three soldier-ERG-SBSS-EL eight nation is-AOP 1pl.abs , russians.also-FOC very was , eight nation is-PST .
and to-the-bottom sea-DAT go-OPT-COND 1sg.abs must fight-INF sea steed-ABS , say-PST-3PL .	« sea-OBL-GEN want-ERG-DAT a.going.MSD for-INELAT-FOC 1sg.abs sea-OBL-GEN steed-ERG-POESS with-DAT fight.AOC want-IMPF » say-ENT .
and elder-SBST said-PERF to younger-SBST : dear sister-VOC your horse-ABS zero-NESS	this elder sister-ERG small-OBL-DAT say-AOR : dear sister , say-AOR , 2sg.gen horse never , say-AOR .
table- PL ground- SUPER on , tablecloth- PL- ERG , village- GEN all child- PL there go- IMPF- COND .	chairs.on-PL open-PST-ENT-PST ground.in-INESS-SPSS , tablecloths-PL-FOC , all village-ERG-GEN child-PL go-ENT-AOP .
we-INCL bear-ACC this but find-OPT couldn't	turns 1pl.abs this bear-OBL-POESS , find-MSD not.make.PRF.PTP-AOP 1pl.gen-DAT .
we/you each other-GEN love-GEN be-1PL	our love-FOC one was , love-FOC one was .
"AT.THAT.TIME say-PST-PTP ""people chase-FUT-ENT out-DAT"" and ""king choose-PASS-FUT-ENT"""	AT.THAT.TIME-INESS », say-ENT , « it will.chase.FUT-ENT public-ERG », say-ENT , « 2sg.abs king choose.IMP-INESS » say-ENT .
go-PTP-1SG Derbent-DAT	1sg.abs go-PERF-PTP Derbent.in-OBL-DAT
""" their heads cut.off "" said"	« cut.IMPV their chapter-PL » say-AOR .
come-IMP .FUT spring-DAT , Bezkhanum	come come.out-ERG water.on , Bezkhanum
"""I must"", said, ""this soil take and heal your eyes"", said."	« soil-AD-PL », say-AOR , « 1sg.ERG brought.AOR-AOR absolutely 2sg.gen eye-PL heal.AOC-PL-AOR want-INESS », say-AOR .
and-CONJ return-PERF 1sg.abs back-DIR summer-GEN camp-DAT-ADESS , rest-INF-DAT .	after return-PERF 1pl.abs summer camp-DIR-DAT , to.have.a.rest-INF .
"see-PST I-ERG Isabala-OBL tell-PST-I-DIR "" brother Isabala dog-POESS give.birth-PRF-ENT puppy-PL-ABS return-IMP-ENT I-DAT dog-ABS please"	Isabala seen-TEMP say-AOC that 1sg.ERG , « Isabala brother , puppy-PL-FOC be-AOR say-IMPF , give 1sg.gen dog .
puts-ENT woman that scale-ABS.PL on one-OBL plate-ADD.PL-DAT person-ABS truth justice uprightness purity on another-OBL plate-ADD.PL-DAT	then justice scale-DIR-AD one side.on put.IMPV-PERF that,.the.same man , another side.on-FOC – truth , justice , right-PURP , today-PURP , cleanless-PURP .
but when he-ERG her-ABS disembark-IMPF-ENT deceive-IMPF-ENT and was-IMPF take-PTP-ENT his-GEN house-DAT this girl from-him run-away-IMPF-ENT	he.and taking.down.AOC girl deceiving.AOC her house-OBL-DAT when.taking.TEMP this girl ran.ENT his arm.from .
door-PL one knock-PTP 1PL.ERG home-ABL kazakh man come-out-PTP 3SG.M	run.IMP-AOR 1pl.erg one window-INESS , apperance-AOR here-SPSS , kazakh was
"""call"", said, ""and this guy king that way let be, I queen will-be ."""	« call?-ERG », say-AOR , « this boy today-GEN-ERG-GEN day.from be-ENT king , 1sg.abs-FOC his wife .»
unfaithful-NESS, untrusted-NESS	unfaithful , untrusted .
Зунни I-and ER-ERG MEN-POESS IDI-ASSOC-SBSS-A.LITTLE-PTP-PRF-ABS XUER-SBSS-NESS-ABS	1sg.abs-FOC armenian-DIR-POESS on.the.contrary
at-this.moment , three-POESS son-DIR say-AOR , father now I-will-bring-it-AOR , say-AOR .	AT.THIS.TIME-INESS THIRD-PST boy-ERG say-AOR : « dear father », say-AOR , « now 1sg.ERG will.bring-INESS », say-AOR .
but , ask-IMP-ENT , come-INF-DIR next time-TEMP , give-INF DAT mother-DAT petition-ABS	but , say-AOC , come-ENT-PST time-INESS , say-AOC , come , say-AOR , mother-DIR-DAT one statement to.give you.know 1pl.erg .
heavy-ness flake-ness of.snow	snow-INESS-DIR-GEN small flake you.know , flake
do you remember	2sg.gen heart-ERG-SPSS still.remember-Q ?)
well history-GEN.PL about say-PST-ENT 3PL history-GEN exactly-from time-ACC not-say-OPT-ENT 1SG time-PL-ACC not-show-OPT-ENT 1SG	well , history-OBL-GEN this evidence-PL say-PST-TEMP , history-OBL-GEN FROM.EXACTLY , they you.know — Uhm , Uhm , time 1sg.ERG-AD-EL say-INF be-FUT-NEG , time-PL show be-FUT-NEG 1sg.ERG-AD-EL 2pl.dat-DAT .
1sg A.party-DAT take-PASS-PST-ENT , 1sg vacation ten day get-PASS-PST-ENT , this.all Soviet.government during	1sg.abs that soviets' time-DIR-DAT party-DIR-DAT take.over , 1sg.ERG-DAT vacation give-AOR ten 24.hour.period , such-PL be-AOR .
he , decide-PERF , DET dam-INESS down go-INF	but , say-AOC , one down dam-INESS-SPSS go-MSD 1pl.abs .
therefore that.time child child head-on.top of-NEG.PST ...	that-ERG-SPSS 1pl.erg , 1sg.abs , 1sg.abs in.the be ...
that time-DAT come-back-PST-ENT , captain .	then on 1pl.gen that return-AOR , captain .
« Samur » newspaper-GEN fire still exists	"« ""Samur"" » newspaper-OBL-GEN fireplace-INESS today-FOC fire cop-IMPF ."
then finish-ENT ... we mortar-PL man-PL be-PST , there three be-PRF NEG-more	finish happened-AOR ... there-SPSS 1pl.abs mortar.men was , mine-PL threw.ENT-ENT-PST three person
and-FOC 3PL.ERG he-ACC she-ACC on-DAT throne-SUPER put	They.and he put.ENT that.on and her throne.on seat.ENT .
nan	die-IMP still.be,.remain !
"those-ERG this boatman-OBL call-IMPF and say-IMPF ""brother you must us that side sea-GEN across bring-PURP"""	called.ENT this boatman-DIR-DAT say-ENT that , « dear brother , 1pl.abs » say-ENT « sea-OBL-GEN other bank-ERG-DAT get.out-AOR want-ENT 2sg.abs-ERG ».
dear Bezkhanum , dear Bezkhanum	soul Bezkhanum , soul Bezkhanum
all person-PL-ERG call-PERF-PASS-PL gather-PERF-PASS-PL	to.gather-AOR man-PL call.IMPV-ENT all .
this-ABS why guide-PRS-ENT	what.for for took ?
at-this.moment third son said chan father now bring-OPT -it	AT.THIS.TIME-INESS THIRD-PST boy-ERG say-AOR : « dear father », say-AOR , « now 1sg.ERG will.bring-INESS », say-AOR .
we-ERG food had , I-ERG water went , I-ERG a.little drank .	1sg.abs-FOC bread ate-AOC , 1pl.erg three-ERG , 1sg.abs-FOC water-SPSS go-AOR .
you too much think-PRF-SBST	« very 2sg.abs attention-DIR-DAT go-PERF that ».
1sg.gen mother teacher be.pst-3sg, 1sg.gen father accountant be.pst-3sg	my mother teacher was , my grandfather-AND accountant was .
and then return-1SG free , finally , family-POESS	then return-AOR free , thing-OBL-GEN , family-OBL-DAT
someone run-ENT	one escape-IMPF .
1sg-GEN mind NEG change-PERF-NEG that so	decision-DIR-SPSS-EL 1sg.abs separated isn't , say-IMPF .
I-ERG earlier anticipated-ABS than promoted-PTP-PASS-PRF Sergeant-ABS	there-SPSS-EL after 1sg.ERG-DAT earlier rank sergeant give-AOR .
and that-ABS say-AOR what ashuq-ERG	like.that happened-AOP-TEMP love-DIR what say-IMPF ?
Again-TEMP go-PERF 1sg.ERG shepherd-PL-GEN courtyard-DAT	go-ENT 1sg.abs shepherd-DIR-GEN yard.in-INESS-SPSS .
but , surface on blood no there is-NEG-IMPF I-POESS no more exist-NEG-INF , said-IMPF horse-MSD the .	no , sea-OBL-GEN on blood apperance NEG.make.PTP-COND , 1sg.abs exist.doesn't », say-INESS .
king- ERG, “I- NOM boy- VOC”, said- PERF, “this- DIR way- DAT, come- PERF.CONT house- GEN.PL pearl- PL exist- PRF” come- PERF.CONT .	coming-PST-TEMP , « oh boy », say-ENT , « 1sg.ERG-DAT voice coming-AOR , say-AOR , 2sg.gen house-INESS pearls-PL cop » say-AOR .
then-TEMP we-PL go-PTP Chukotka-DAT	there.from after to.go-HORT 1pl.abs Chukotka-ERG-DAT .
and may-SBST god bless-OPT-ENT this-PL .	he-AOP people-DIR-SPSS-INELAT Allah agree let.it.be.OPT .
sometimes offend-IMP-1PL.ASS-RECIP also	2sg.abs 1sg.ERG-SBSS-EL , 1sg.abs 2sg-SBSS-EL worry was time-PL-Q be-AOR .
mother	there .
and past in.general good-NESS-TEMP-IMPF be-PST-3PL	that times commonly disaster was .
until we-ERG him-OBL water-GEN out put	this let.us.out so.much , 1pl.erg water let.us.out so.much time-OBL-SPSS .
and-CON they-ERG picture-ACC take-PTP-PL-DIR spring-INE-LOC put-PERF-PL	these-ERG-Q take-ENT this picture put.IMPV-ENT spring-INESS-SPSS .
so 1SG see-PST-MSD young man-ABS face-GEN like us-GEN a.little-DIR look-IMPF-ENT	that,.the.same like.this , one boy look-AOC 1sg.ERG-DAT ours similar was face-INELAT one A.LITTLE .
"guy think-AOR "" wonder 1SG leave-SUB girl here go-SUB first father come-OPT take-OPT """	guy.ERG.and attention-ENT , « I.wonder » say-ENT « 1sg.abs going.PTP.COND before girl here puting.AOC if.do grandfather-DIR coming-AOR girl steal.INF did.again.ENT-INESS .
in.the.end many thought-IMPF-DIR after girl-DAT board-IMPF-ENT and girl-DAT boat-INS send-PERF-ENT to other.side	after.all very a.thinking.MSD.off after girl boarding.AOC boat-INESS , sent.ENT this girl boat.in.being.IMC other side .
"that-PL boatman-PL-DIR call-PST-ENT and ask-PST-ENT ""brother you that-sea-ACC other-side-DAT take-IMPF-SBSS-PURP us-ACC"""	called.ENT this boatman-DIR-DAT say-ENT that , « dear brother , 1pl.abs » say-ENT « sea-OBL-GEN other bank-ERG-DAT get.out-AOR want-ENT 2sg.abs-ERG ».
two we run-OPT-PST	1pl.abs two escaped-AOR .
nan	04 : 19
"""at.that.time"" she-said ""the people it-ACC chase.out FUT and you king as chosen.will.be"""	AT.THAT.TIME-INESS », say-ENT , « it will.chase.FUT-ENT public-ERG », say-ENT , « 2sg.abs king choose.IMP-INESS » say-ENT .
battalion-POESS-GEN land.surveyor 1sg.ERG be.PTP	battalion's-DIR-GEN land.surviver was 1sg.abs
we engage-PTP May-in and marry-PTP September-in	May-OBL-DAT engagament be-AOR , sentyabr-OBL-DAT 1pl.abs married be-AOR .
"""it-ABS not will-work this way-INS,"" they said."	« like.that will.not.be that », say-ENT .
and-CONJ he-NOM write-PST-PRF new-ADJ love-ADJ song-ABS to-DAT Bezkhanum-DAT	love-PL-ERG-DAT her-GEN new chapter-EL song-PL created-AOR Bezkhanum-ERG-DAT :
we-PL be-PST very friendly-NESS and kind-NESS .	brother-PL-OBL-POESS with kind happened-AOC , good happened-AOR .
ask-AOR 3SG.abs help-INF 1SG.DAT say-INF 3SG.abs back take-INF 1SG.DAT say-INF 3SG.abs .	1sg.abs , say-AOR , help do , 1sg.abs take.back , say-AOR , here-ERG leave-PROH , say-AOR .
ever that-FUT want will-COND that woman-GEN son-ABS kill-SBST-PASS-OPT-MSD ?	himself-ERG-GEN son way-ERG-DAT want be.FUT.Q ?
and you-DU must give a word-INF to ashuq-DAT even if-CON the whole world-ABS against you-ABS be-FUT-SBSS	but , say-IMPF , Bezkhanum , say-IMPF , world.on-INESS all one side if.is , ashuq-DIR-DAT 2sg.abs-ERG word give-AOR want-FUT .
"""dear old grandmother-Q"" saying-EL, ""a daughter need-NEG you-Q"", saying-EL, ""a child want-NEG you-Q"", saying-EL ?"	« dear old.woman grandmother » say-ENT , « 2sg-DAT girl want-ENT-FOC », say-ENT , « 2sg-DAT one baby want-ENT-FOC », say-ENT ?
that-EL release-IMPF bird-OBL that fly-AOR and sit-AOR girl-GEN shoulder-ABS	release.IMMANT-IMC FLEW-AOR coming-AOR this bird sitting.down.AOC-ENT girl-ERG-GEN shoulder-INESS-SPSS .
"""them-DAT bring-FUT-1SG-OPT now-DIR please-SBST don't-NEG touch-AOR-2SG-OBL"""	« now-INESS bring.IMPV.Q-FOC 1sg.ERG 2sg-DAT », say-ENT , « 1sg.ERG-POESS touch.not.PROHIB-PROH only ».
we village-DAT that-DIR reach-PTP	1pl.abs return-AOR this one there village-ERG-DAT
"horse ask-OPT "" what happen-PERF "" ask-OPT "" why head down-PERF again "" ask-OPT "" what happen-PERF what think-IMPF-SBST about-DAT"	horse-ERG say-ENT : « what happened-PERF », say-ENT , « more-FOC head hang.AOC-AOR that », say-ENT , « what happened-PERF , what attention-PL-IMPF ?»
