predicted_glosses	glosses
when young-CN REL come-over-ANTIP-3SG.II, when come-over-ANTIP-3SG.II DEM around live-3SG.II LOC-PN Gitsegyukla, PN-Gitsegyukla	still IPFV-CN small-little-1SG.II still small-little-1SG.II time COMP-CN toward come-CN PART relative PREP-OBL-CN LOC-CN Gitsegyukla
CCNJ live-PROG-1PL.II LOC-CN mother-POSS.II father-POSS.II house	still IPFV-CN live-1PL.II LOC-CN in house-PN mother-1PL.II PCNJ father-1PL.II
CCNJ over come-3SG. Man ERG over be.called-3SG. Man ERG over come-3SG. Jacob Brown	CCNJ toward come-PN Man-CN name-3.II Man toward arrive Jacob Brown
CCNJ want-CN tell story about hunt-CN IPFV-3SG.M-TR.PRF-CN when	CCNJ want-3.II PROSP-3.I tell-T-CN MANR LVB-3.II COMP IPFV-CN hunt-ANTIP-3.II
CCNJ before go-3SG.III PROSP DEM time	CCNJ INCEP IPFV PROSP away go-3.II
CCNJ gather-CN everything for use-CN PROSP catch-3SG.II what PROSP hunt-3SG.II	CCNJ-3.I take.PL-CN all 3.III-CN CNT.AMT-CN PROSP use-TR-3.II PROSP MANR CIRC.PSBL hunt-ANTIP-3.II
and want-3 PROSP tell-3 1PL-DAT manner do-3.II	CCNJ want-3.II PROSP-3.I tell-T-3.II OBL-1PL.II MANR LVB-3.II
and make-PFV-3 . 2PL.II sit-CAUS-PFV-3 . 1SG and sibling-PL.II sit-CAUS-PFV-1SG	CCNJ-3.I sit.PL-T-1PL.II sit-T-TR-3.II 1PL.III 1SG.III PCNJ-CN PL-sibling-PASS-1SG.II
"CCNJ on that time PFV-say-3SG.II ""PROSP 1SG-tell-FUT-1SG you-DAT"""	CCNJ on COMP say-3.II PROSP tell-T-TR-1SG.II PN-DEM.PROX OBL-2SG.II
PROG go.hunting-1SG.II and be.there-PST CCNJ grouse=OBV be.there-PST CCNJ in.the.way=LOC be.there-PST he=Q say-PAST.3	IPFV-CN go-1SG.II PROSP hunt-ANTIP-1SG.II CCNJ sit-CN grouse block.way sit-CN grouse QUOT.3SG 3.III
CCNJ IPFV-1SG see-1SG.II.PROG moose	CCNJ 1.I see-CN moose
want-1SG . ABL-3SG feed-CN PROSP COMP village-POSS.1SG	IPFV-CN want-1SG.II PROSP 1.I eat-CAUS2-CN contain-village.people-1SG.II
CCNJ if move-1SG.II ' ' ' ' he-ERG	CCNJ IRR-SPT move-PASS-1SG.II QUOT.3SG
PROSP 1.I fly.away-CN grouse PROSP 1.I run.away-CN moose REL want-1SG	PROSP CCNJ fly-CN grouse PROSP CCNJ flee.PL-CN moose want-1SG.II
and CCNJ-1.I NEG make-3.II sound Man	CCNJ on COMP NEG-FOC SUPER-make.noise-PASS-PN Man
sit-3SG.M still PROSP look-3SG.M CON us look-3SG.M CON PROSP see-1PL-OBJ look-3SG.M CON PROSP work-1PL	keep.on sit 3.III see-3.II 1PL.III see-3.II MANR make-T-TR-1PL.II see-3.II MANR LVB-1SG.II
CCNJ ask-1PL.II what 3-ERG do-PAST	CCNJ-1.I 1PL.I ask what-CN LVB-3.II
what shoot-PAST-2.SG hunt-INST grouse or moose	what-CN CONTR shoot-TR-2SG.II grouse IRR DWID moose
CCNJ then sit-3.PROG down-ADV	CCNJ on COMP sit-3.II
CCNJ say-CN COND PROSP shoot-1SG.II grouse-CN	CCNJ say-3.II IRR-SPT 1.I shoot grouse
if IPFV-1SG.II shoot-CN grouse PROSP be-1SG.II only eat-PASS-1SG.II	IRR-SPT 1.I shoot grouse PROSP CCNJ only one.HUM 1SG.III PROSP eat-PASS-SX
CCNJ if wait-1SG.II PROSP walk.away-3SG.III COND PROSP CONJ grouse	CCNJ IRR-SPT wait-ANTIP-1SG.II completely PROSP NMLZ away go-CN grouse
PROSP go-1SG.II PROSP close MOSS PROSP win-MOSS MOSS PROSP get-1SG.II close MOSS very .	PROSP CCNJ-1.I CIRC.PSBL PROSP toward go LOC-CN little-ATTR toward close-CAUS2-ANTIP-1SG.II LOC-CN moose
and PROSP FOC be.able-1SG shoot-FUT it and PROSP all PNPL eat-FUT .	PROSP CCNJ-1.I CIRC.PSBL PROSP 1.I shoot-3.II PROSP CCNJ eat.PL-PASS-CN all 3.III-CN people
CCNJ 1.I-CCNJ COMP-3.MASC finish-TR-3.MASC tell-TR-3.MASC 1.PL.INCL-OBL then 3.MASC-ERG go-TR-3.MASC home	CCNJ on COMP finish-PASS-3.I tell-T-3.II OBL-1PL.II CCNJ leave go.home-3.II
CCNJ then after two day PL.OBL again see-1SG.II 3.OBL-PROSP-IPFV again	CCNJ INCEP two day finish-SX away leave-SX time COMP-CN 1.I just-again see-3.II
and I-ERG run-3 toward him-DAT and I-ERG say-3 toward him-DAT	CCNJ toward run-1SG.II LOC-3.II CCNJ on COMP say-1SG.II OBL-3.II
INTJ be.able-2SG tell-INF what happen-TR-3SG.N .INT about grouse	NEG-2.I CIRC.PSBL PROSP-2.I tell-T-CN MANR LVB-CN grouse PR.EVID
"and then he VERUM-say: ""I FUT be.at your mother house and I FUT tell you"""	CCNJ on COMP say-3.II PROSP toward arrive 1SG.III LOC-CN house-PN mother-2SG.II PROSP CCNJ-1.I tell-T-3.II OBL-2SG.II
CCNJ go-1SG.II home and wait-1SG.II CCNJ-3.II for 3.III then tell-TR-3.II 1SG about grouse-PL	CCNJ back go.home-1SG.II CCNJ 1.I wait-ANTIP-1SG.II OBL-3.II CCNJ-3.I tell-T-CN MANR LVB-CN grouse
CCNJ when tell-3SG.II CCNJ then 3SG.II-CCNJ say-3SG.II	CCNJ IPFV-3.I tell-T-3.II CCNJ on COMP say-3.II
IPFV-CN hunt-1SG.II CCNJ want-PAST-1PL get-INF moose	IPFV-CN hunt-ANTIP-1SG.II CCNJ want-1PL.II PREP-OBL-CN moose
CONJ want-1PL.II CONJ feed-FUT-1PL.II all people but grouse-ERG obstruct-PAST-3SG.II CONJ CONJ say-PAST-1PL.II	CCNJ want-1PL.II PROSP eat-CAUS2 all 3.III-CN people CCNJ block.way sit-CN grouse
CCNJ if move-1SG.II PART-CN CCNJ grouse fly.away-3SG.III	CCNJ IRR-SPT move-PASS-1SG.II PROSP CCNJ fly grouse
CCNJ that OBL grouse-OBL start-R fly-R make-R sound betl'a betl'a betl'a betl' .	CCNJ on COMP say-PN Man flap flap flap flap QUOT.3SG PROSP MANR fly-CN grouse
as.soon.as move-1.I CCNJ say-CN CCNJ as.soon.as move-1.I break-CN stick=OBL	true on COMP move-PASS-1SG.II QUOT.3SG true on COMP move-PASS-1SG.II break-CAUS2-1SG.II-CN stick
CCNJ noisy-CCNJ when fly-3 grouse CCNJ and 2.SG-hear-3PL when fly-3PL 3PL: sound sound sound sound sound .	CCNJ noisy-CN COMP-FOC-3.I fly.PL-CN grouse CCNJ on COMP fly-3PL.II CCNJ-2.I hear-3.II flap flap flap flap flap
CCNJ NEG want-TR-1SG.II SO-that moose game-POSS.II LVB-3SG.II run-TR-3SG.II because grouse exist-3SG.II	CCNJ NEG-FOC want-1SG.II PROSP NMLZ move-PASS-1SG.II PROSP MANR flee.PL-CN moose hunt-ANTIP-1SG.II COMP block.way sit-CN grouse
every time see-1SG.II MAN Jacob Brown CCNJ 2SG.OBL ask-1SG.II say-2SG.II story about betl'a betl' tell-2SG.II us	COMP-1.I HAB see-PN Man Jacob Brown CCNJ 1.I again ask-3.II NEG-2.I CIRC.PSBL PROSP-2.I tell-T-CN MANR LVB-CN flap flap OBL-1PL.II-Q
CCNJ DEM time call.by.name-PAST-3.II REF Man name Betl'a-DIM Betl'-DIM	CCNJ on COMP CAUS1-sit-DETR-ATTR CAUS1-name-T-TR-1SG.II-DM Man Betl'a Betl'
DEM CN CONV LVB-1SG.II now name-PASS-1SG.II PN Betl'a Betl'	on REAS COMP-CN name-1SG.II now PREP-PN Betl'a Betl'
That-be.enough-1SG.II	CNT.AMT-CN say-1SG.II
