predicted_glosses	glosses
« 1SG.ABS », say-AOR , « go-AOR man-ERG-GEN between-INESS enter-FUT-FUT , look-HORT maybe 1SG.GEN fate-INESS cop .»	« 1sg.abs », say-AOR , « go-AOR man-ERG-GEN between-INESS enter.FUT-FUT , look.HORT maybe 1sg.gen fate-INESS cop .»
decision one be.3sg	agreement-PL one was .
« And.but 1pl.abs they-ERG-GEN to return-AOR want-ENT , come group happened-AOR go.back-HORT 1pl.abs .»	« And.but 1pl.abs them-ERG-GEN to returned-AOR want-ENT , come group happened-AOR go.back.HORT 1pl.abs .»
love what be.3sg hey ashuq-voc	love what was , ashuq boy ?
what-ERG, where be-AOR ?	what-DAT , where be-AOR ?
many time say-AOR-PL , happen-AOR , 1pl.abs event-ABL happy be-AOR .	good toasts-PL say-AOR , agreements-PL be-AOR , 1pl.abs event.from-OBL-SUPER-EL agree remain-AOR .
and Chukotka cold place be-PST , I too cold be-PST	well Chukotka cold place was , cold place was .
( Natavan )	( Natavan ).
they-ERG « call.IMPV that boy » say-ENT , « they 2sg-DAT take.IMPV » say-ENT , « they he-DAT worthy neg.cop ».	they-ERG « call.IMPV that boy » say-ENT , « they 2sg-DAT take.IMPV » say-ENT , « they he-DAT worthy cop.NEG ».
then this boy-ERG say-ENT that , « but now all happened-PERF », say-ENT , « grandfather-DIR punishment take-AOR , other-ERG-FOC punishment take-AOR , but ,» say-AOR , « other province.in-INESS 1sg.gen mother-FOC be.still » say-AOR , « three brother-FOC be.still , two brother-FOC be.still » say-AOR .	then this boy-ERG say-ENT that , « but now all happened-PERF », say-ENT , « grandfather-DIR-FOC punishment take-AOR , others.and-ERG-FOC punishment take-AOR , but ,» say-AOR , « other.one province.in-INESS 1sg.gen mother-FOC still.be,.remain » say-AOR , « three brother-FOC still.be,.remain , two brother-FOC still.be,.remain » say-AOR .
« this pouring.out-AOR that,.the.same king-DIR-GEN over-SPSS-INAL say.IMP that » say-ENT , « or dog be.FUT.OPT , or pig be.FUT.OPT ».	« this pouring.AOC-AOR that,.the.same king-DIR-GEN over-SPSS-INELAT say.IMP that » say-ENT , « 2sg-SBSS-EL or dog be.will-AOP , or pig be.will-AOP ».
more-FOC go-AOR himself yard.in-INESS-SPSS .	more-FOC go-AOR himself yard.in-INESS-SPSS .
they.and-ERG-FOC punishment order.IMPV » say-AOR .	they.to.also punishment order.IMPV » say-AOR .
eight three soldier-PL-from nation PL be-PST many Russian-PL-GEN much nation PL be-PST	Twenty three soldier-ERG-SBSS-EL eight nation is-AOP 1pl.abs , russians.also-FOC very was , eight nation is-PST .
« sea-OBL-GEN want-ERG-DAT go-ENT end-POSS where.to-ABS sea-OBL-GEN steed-POSS with fight.FUT-ENT must », say-ENT .	« sea-OBL-GEN want-ERG-DAT a.going.MSD for-INELAT-FOC 1sg.abs sea-OBL-GEN steed-ERG-POESS with-DAT fight.AOC want-IMPF » say-ENT .
this big-OBL-POSS sister say-AOR : dear sister , 2sg.gen this horse nothing be-AOR , say-AOR .	this elder sister-ERG small-OBL-DAT say-AOR : dear sister , say-AOR , 2sg.gen horse never , say-AOR .
table-PL be-again-ENT-ENT-AOP ground-DIR-SPSS , tablecloth-PL-FOC , all village-ERG-GEN child-PL go-IMPF .	chairs.on-PL open-PST-ENT-PST ground.in-INESS-SPSS , tablecloths-PL-FOC , all village-ERG-GEN child-PL go-ENT-AOP .
we-ERG look-for-PERF this bear but place-INESS not.find-AOR	turns 1pl.abs this bear-OBL-POESS , find-MSD not.make.PRF.PTP-AOP 1pl.gen-DAT .
1pl.gen heart-PL-ERG-DAT each other be-PRS , each other want-ENT-PRS .	our love-FOC one was , love-FOC one was .
that~time-INE-INDEF », say-ENT , « one people-PL chase-FUT-ENT-PL », say-ENT , « 2sg.abs king elect-FUT-PASS-ENT », say-ENT .	AT.THAT.TIME-INESS », say-ENT , « it will.chase.FUT-ENT public-ERG », say-ENT , « 2sg.abs king choose.IMP-INESS » say-ENT .
1sg.abs go-MSD Derbent-INESS-SPSS	1sg.abs go-PERF-PTP Derbent.in-OBL-DAT
« cut.IMPV their head-PL » say-AOR .	« cut.IMPV their chapter-PL » say-AOR .
come come.out water-SPSS , Bezkhanum	come come.out-ERG water.on , Bezkhanum
« SOIL-PL », say-AOR , « 1SG.ERG bring.AOR-AOR absolutely 2SG.GEN eye-PL heal-AOC-PL-AOR want-INESS », say-AOR .	« soil-AD-PL », say-AOR , « 1sg.ERG brought.AOR-AOR absolutely 2sg.gen eye-PL heal.AOC-PL-AOR want-INESS », say-AOR .
after return-PERF 1pl.abs summer camp-DIR-DAT , rest-INF .	after return-PERF 1pl.abs summer camp-DIR-DAT , to.have.a.rest-INF .
that-time himself see-AOR say-AOC that , « Isabala was brother , puppy-PL-ERG be-AOR 1sg.ERG-DAT say-IMPF , dog return-IMPV 1sg.DAT please »	Isabala seen-TEMP say-AOC that 1sg.ERG , « Isabala brother , puppy-PL-FOC be-AOR say-IMPF , give 1sg.gen dog .
then one scale-ABS that plate-ADE one on put-IMPV-PERF that person , another plate-ADE – that,.the.same truth , justice , uprightness , purity , honesty .	then justice scale-DIR-AD one side.on put.IMPV-PERF that,.the.same man , another side.on-FOC – truth , justice , right-PURP , today-PURP , cleanless-PURP .
he-ERG taking-down-AOC girl deceiving-AOC 3SG.ABS house-OBL-DAT when-taking-TEMP this girl ran-ENT 3SG.ABS arm-ABL	he.and taking.down.AOC girl deceiving.AOC her house-OBL-DAT when.taking.TEMP this girl ran.ENT his arm.from .
knock-AOR 1pl.erg one door-acc , apperance-AOR home-SPSS , kazakh be-AOP	run.IMP-AOR 1pl.erg one window-INESS , apperance-AOR here-SPSS , kazakh was
« call?-ERG », say-AOR , « this boy today-GEN-ERG-GEN day.from be-FUT king , 1sg.abs-FOC his wife .»	« call?-ERG », say-AOR , « this boy today-GEN-ERG-GEN day.from be-ENT king , 1sg.abs-FOC his wife .»
unfaithful , untrusted .	unfaithful , untrusted .
1SG.ABS-FOC ARMENIAN-DIR-POESS ON.THE.CONTRARY	1sg.abs-FOC armenian-DIR-POESS on.the.contrary
this-time-INAL three-ORD say-AOR , « father », say-AOR , « now that.thing-ABS bring-FUT-1SG.SG », say-AOR .	AT.THIS.TIME-INESS THIRD-PST boy-ERG say-AOR : « dear father », say-AOR , « now 1sg.ERG will.bring-INESS », say-AOR .
but , say-AOC , come-IMP next time-OBL-DAT , say-AOC , that , say-AOC , mother-OBL-DAT one give-HORT you.know three-ERG .	but , say-AOC , come-ENT-PST time-INESS , say-AOC , come , say-AOR , mother-DIR-DAT one statement to.give you.know 1pl.erg .
heavy snow-flake-PL fall-INESS , fall-IND	snow-INESS-DIR-GEN small flake you.know , flake
2SG.ABS-OBL-heart-one remember-INT	2sg.gen heart-ERG-SPSS still.remember-Q ?)
well , history-GEN this evidence-PL say-AOR history-GEN exactly from , thing-PL-OBL yes , uhm , uhm , time say-INF be-FUT-NEG this history-GEN , show-INF be-FUT-NEG 1sg.ERG you.to-DAT .	well , history-OBL-GEN this evidence-PL say-PST-TEMP , history-OBL-GEN FROM.EXACTLY , they you.know — Uhm , Uhm , time 1sg.ERG-AD-EL say-INF be-FUT-NEG , time-PL show be-FUT-NEG 1sg.ERG-AD-EL 2pl.dat-DAT .
1sg.abs a Soviet-GEN government-INESS party-INESS-DAT accept-AOR , say-AOC vacation give-AOR 1sg.ERG-DAT ten day , that.time be-AOC .	1sg.abs that soviets' time-DIR-DAT party-DIR-DAT take.over , 1sg.ERG-DAT vacation give-AOR ten 24.hour.period , such-PL be-AOR .
and, say-AOR, this down go-AOR dam-INESS-DAT go-MSD one.	but , say-AOC , one down dam-INESS-SPSS go-MSD 1pl.abs .
that but 1sg.abs 1sg.abs head-on be.able-NEG-AOR ...	that-ERG-SPSS 1pl.erg , 1sg.abs , 1sg.abs in.the be ...
then on 1pl.gen that return-AOR , captain .	then on 1pl.gen that return-AOR , captain .
"« ""Samur"" » newspaper-OBL-GEN fireplace-INESS fire exist-IMPF"	"« ""Samur"" » newspaper-OBL-GEN fireplace-INESS today-FOC fire cop-IMPF ."
finish be-AOC ... mortar.man be-AOR 1pl.abs , three one there-SPSS	finish happened-AOR ... there-SPSS 1pl.abs mortar.men was , mine-PL threw.ENT-ENT-PST three person
THEY.and-ERG put.ENT that-OBL on and she-ERg throne-OBL seat.ENT	They.and he put.ENT that.on and her throne.on seat.ENT .
this but	die-IMP still.be,.remain !
call.IMPV-INESS this boatman-DIR-DAT say-ENT , « was brother , 1pl.abs » say-ENT « go-GEN other side-DIR sea-OBL-GEN take.out-AOC want-FUT 1pl.abs » .	called.ENT this boatman-DIR-DAT say-ENT that , « dear brother , 1pl.abs » say-ENT « sea-OBL-GEN other bank-ERG-DAT get.out-AOR want-ENT 2sg.abs-ERG ».
soul Bezkhanum , soul Bezkhanum	soul Bezkhanum , soul Bezkhanum
to.gather-AOR man-PL call-IMPV-ENT all .	to.gather-AOR man-PL call.IMPV-ENT all .
why be.guided-PRS-3SG.F she it	what.for for took ?
and-CONJ this.time-LOC three-ORD boy-ERG say-AOR : « dear father », say-AOR , « now that.thing-ABS will.bring-ENT », say-AOR .	AT.THIS.TIME-INESS THIRD-PST boy-ERG say-AOR : « dear father », say-AOR , « now 1sg.ERG will.bring-INESS », say-AOR .
1SG.ABS-FOC BREAD EAT-AOC , 1PL.ERG THREE-ERG , 1SG.ABS-FOC WATER-SPSS GO-AOR .	1sg.abs-FOC bread ate-AOC , 1pl.erg three-ERG , 1sg.abs-FOC water-SPSS go-AOR .
« very 2sg.abs mind-DIR-DAT go-PERF that »	« very 2sg.abs attention-DIR-DAT go-PERF that ».
my mother teacher be-PTP , my father accountant be-PTP .	my mother teacher was , my grandfather-AND accountant was .
and then return-AOR 1sg.abs free be.PRS-1sg.abs , alone be.PRS-1sg.abs , family-DIR	then return-AOR free , thing-OBL-GEN , family-OBL-DAT
one escape-IMPF .	one escape-IMPF .
1sg.abs-mind-INESS change-IMPF-N-PTP cop NEG say-IMPF .	decision-DIR-SPSS-EL 1sg.abs separated isn't , say-IMPF .
early after 1sg.ERG-DAT early honorary sergeant give-AOR .	there-SPSS-EL after 1sg.ERG-DAT earlier rank sergeant give-AOR .
and what ashuq say-IMPF 3SG.ERG-FOC ?	like.that happened-AOP-TEMP love-DIR what say-IMPF ?
go-ENT 1sg.abs shepherd-DIR-GEN yard.in-INESS-SPSS .	go-ENT 1sg.abs shepherd-DIR-GEN yard.in-INESS-SPSS .
no , sea-OBL-GEN on blood appearance NEG-make-PTP-COND , 1sg-abs exist-NEG », say-INESS .	no , sea-OBL-GEN on blood apperance NEG.make.PTP-COND , 1sg.abs exist.doesn't », say-INESS .
coming-PST-TEMP , « oh boy », say-ENT , « 1sg.DAT voice coming-AOR , say-AOR , 2sg.GEN house-INESS pearls PL cop » say-AOR .	coming-PST-TEMP , « oh boy », say-ENT , « 1sg.ERG-DAT voice coming-AOR , say-AOR , 2sg.gen house-INESS pearls-PL cop » say-AOR .
there-PST after that to go-AOR 1pl.abs Chukotka-DAT	there.from after to.go-HORT 1pl.abs Chukotka-ERG-DAT .
and mother-OBL-PL-OBL Allah these bless-PST	he-AOP people-DIR-SPSS-INELAT Allah agree let.it.be.OPT .
sometimes each.other-OBL offend-IMPF-PST be-AOR 1pl.abs .	2sg.abs 1sg.ERG-SBSS-EL , 1sg.abs 2sg-SBSS-EL worry was time-PL-Q be-AOR .
there .	there .
but past in awesome be-AOP	that times commonly disaster was .
until put-IMPF-CONJ 1pl.abs , that water put-IMPF-CONJ him out	this let.us.out so.much , 1pl.erg water let.us.out so.much time-OBL-SPSS .
these-ERG take-ENT this picture put.IMPV-ENT spring-INESS .	these-ERG-Q take-ENT this picture put.IMPV-ENT spring-INESS-SPSS .
that,.the.same 1sg.erg , one this boy-erg 1sg.erg-dat see-aor that look-ent-ptp 1pl-gen a.little .	that,.the.same like.this , one boy look-AOC 1sg.ERG-DAT ours similar was face-INELAT one A.LITTLE .
guy-ERG and think-ENT , « I.wonder » say-ENT « 1SG going-PTP-COND before girl here put-AOR if do grandfather-DIR coming-AOR girl steal-INF again do-PAST-ENT-INESS .	guy.ERG.and attention-ENT , « I.wonder » say-ENT « 1sg.abs going.PTP.COND before girl here puting.AOC if.do grandfather-DIR coming-AOR girl steal.INF did.again.ENT-INESS .
after.all very think-PL-AOR-MSD after girl board-AOC boat-INESS , send-ENT DEM girl boat-IN-be-IMC other side .	after.all very a.thinking.MSD.off after girl boarding.AOC boat-INESS , sent.ENT this girl boat.in.being.IMC other side .
call.IMPV-INESS this boatman-DIR-DAT say-ENT that , « hey brother , 1pl.abs » say-ENT « go.GEN other side sea-OBL-GEN take.out-AOC want-FUT 1pl.abs ».	called.ENT this boatman-DIR-DAT say-ENT that , « dear brother , 1pl.abs » say-ENT « sea-OBL-GEN other bank-ERG-DAT get.out-AOR want-ENT 2sg.abs-ERG ».
1pl.abs two escaped-AOR .	1pl.abs two escaped-AOR .
04 : nan	04 : 19
« that.time-INESS », say-ENT , « one people-PL chase-FUT-ENT it-ACC », say-ENT , « 2sg.abs king choose-PASS-FUT-ENT » say-ENT .	AT.THAT.TIME-INESS », say-ENT , « it will.chase.FUT-ENT public-ERG », say-ENT , « 2sg.abs king choose.IMP-INESS » say-ENT .
battalion-PL-GEN land.surveyor be 1sg.abs	battalion's-DIR-GEN land.surviver was 1sg.abs
May in engage-PERF-SBST , September in marry-PERF-SBST .	May-OBL-DAT engagament be-AOR , sentyabr-OBL-DAT 1pl.abs married be-AOR .
« like.that be.IMPF-COND », say-ENT .	« like.that will.not.be that », say-ENT .
and he-ERG this time.in new love song write-AOR to Bezkhanum-DIR	love-PL-ERG-DAT her-GEN new chapter-EL song-PL created-AOR Bezkhanum-ERG-DAT :
friendly very be-HAB-AOR , kind be-HAB-AOR .	brother-PL-OBL-POESS with kind happened-AOC , good happened-AOR .
ZUN, LAG'ANA, KU'MEK AYA, ZUN XUTAX, LAG'ANA, INARA TAMIR, LAG'ANA.	1sg.abs , say-AOR , help do , 1sg.abs take.back , say-AOR , here-ERG leave-PROH , say-AOR .
HIMSELF-ERG-GEN SON WAY-ERG-DAT WANT BE.FUT.Q	himself-ERG-GEN son way-ERG-DAT want be.FUT.Q ?
but , say-IMPF , Bezkhanum , say-IMPF , world-OBL in all one on be-FUT-COND , ashuq-ERG-DAT you word one give want-FUT .	but , say-IMPF , Bezkhanum , say-IMPF , world.on-INESS all one side if.is , ashuq-DIR-DAT 2sg.abs-ERG word give-AOR want-FUT .
« dear old-woman grandmother » say-ENT , « 2SG-DAT girl want-ENT-FOC », say-ENT , « 2SG-DAT one baby want-ENT-FOC », say-ENT ?	« dear old.woman grandmother » say-ENT , « 2sg-DAT girl want-ENT-FOC », say-ENT , « 2sg-DAT one baby want-ENT-FOC », say-ENT ?
release.IMMANT-IMC FLEW-AOR coming-AOR this BIRD sitting.down.AOR-ENT GIRL-ERG-GEN shoulder-INESS-SPSS	release.IMMANT-IMC FLEW-AOR coming-AOR this bird sitting.down.AOC-ENT girl-ERG-GEN shoulder-INESS-SPSS .
« now-INESS bring.IMPV.Q-FOC 1SG.ERG 2SG.DAT », say-ENT , « 1SG.ERG-POSS touch.NEG.PROHIB-PROH only »	« now-INESS bring.IMPV.Q-FOC 1sg.ERG 2sg-DAT », say-ENT , « 1sg.ERG-POESS touch.not.PROHIB-PROH only ».
1PL-ABS arrive-AOR and one there this village-OBL-DAT	1pl.abs return-AOR this one there village-ERG-DAT
horse-ERG say-ENT : « what happened-PERF », say-ENT , « more-FOC head down-AOR that », say-ENT , « what happened-PERF , what think-PL-IMPF ?»	horse-ERG say-ENT : « what happened-PERF », say-ENT , « more-FOC head hang.AOC-AOR that », say-ENT , « what happened-PERF , what attention-PL-IMPF ?»
