predicted_glosses	glosses
"but MID-say-PDIR.YON doctor.med SUBR , "" body-1AUGII already-dry-APPL-1AUGII towel PCLF.HAND-1AUGII ."""	but MID-say-PDIR.YON doctor.med SUBR , “ body-1AUGII CAUS-dry-COS-1AUGI towel PCLF.HAND-1AUGII .”
so.then PFV RL-take-RL-CAUS-COS letter.note DAT.1AUGII those year five be.one vowel PREP Natqgu time DEM2.PROX , be.like-3MINIS name DEM2.PROX : c q r x z .	so.then PFV RL-take-COS-NMLZ.POSS letter.note those five RL-be-COS vowel GEN1A Natqgu time DEM2.PROΧ , krlc-3MINII here-PL : cqrxz .
foreigner that ᴄᴏᴍ.ᴘʟ SUBR-be.big GEN1A school therein be.3MINII name-3MINII priest Tomson COMMA from Australia .	foreigner DEM2.DIST IRR-be SUBR-be.big GEN1A school RL.3AUG-be-3AUGIS ᴄᴏᴍ.ᴘʟ name-3MINII priest Tomson , TPNYM Australia .
and Daniel also NMLZ1-work-APPL-3MINIS book SUBR word DEM2.DIST RL-PAS-MID-say-PDIR.YON PREP English DEM2.DIST dictionary , book dictionary GEN1A Natqgu .	and Daniel work-APPL-3MINII also book GEN1A word DEM2.DIST RL.PAS-MID-say-PDIR.YON PREP English SUBR dictionary , book dictionary GEN1A Natqgu .
chapter DEM2.DIST nine	chapter DEM2.DIST nine
just stay-APPL-1AUGII travel PREP camp week four , and word bishop Baddeley DEM2.DIST RL-go-COS-PDIR.YON DAT.3MINII IRR-travel-PDIR.YON DAT.3MINII PREP Malaita .	be-TR-INTS-just-1AUGI place.DEM2.DIST PREP camp week four , and word bishop Baddeley DEM2.DIST RL-go-COS-PDIR.YON-3MINIS SUBR IRR-travel-PDIR.YON-1AUGI DAT.3MINII place.DEM2.DIST Malaita .
really-INTS push-INTS-1AUGI SUBR DEM2.DIST crawl.out-PL-1AUGI PREP corner , stand.up-1AUGI and be.1AUGII DEM2.DIST RL-rush.up-COS-1AUGII PREP a mountain SUBR-be.small and be.1AUGII DEM2.DIST RL-rest-COS-1AUGII .	push-INTS-REFL-PDIR.YON-1AUGI and crawl-go.through-GDIR.OUT-1AUGI corner.3D DEM2.DIST , stand.up-PDIR.HITHER-1AUGII and be.1AUGII DEM2.DIST RL-hurry-GDIR.UP-COS PREP a mountain SUBR-be.small and be.1AUGII DEM2.DIST RL-rest-COS .
03 . PREP NMLZ1-grow-NMLZ.POSS-1AUGII and image statue.of.a.demon-PL	03 . PREP NMLZ1-be.big-COS-NMLZ.POSS-1MINII and image demon-PL
if mind-2MINII RL-allow-APPL-PDIR.YON-2MINI PREP board PCLF.HAND-2MINII ship PCLF.HAND-1AUGII and pull-PDIR.YON boat PCLF.HAND-1AUGII ?	if allow-APPL-mq(PDIR.HITHER).q(2MINI) NMLZ1-enter-NMLZ.POSS-PDIR.YON-1AUGI PREP ship PCLF.HAND-2MINII and IRR-drag-PDIR.YON-3MINIA boat PCLF.HAND-1AUGII ?”
SUBR paddle-bz(PDIR.YON).o(1MINI) DEM2.DIST PREP ship , PFV RL-say-TR-COS captain SUBR first have.to-test-PDIR.YON-3AUGIA those .	SUBR paddle-GDIR.OUT-bz(PDIR.YON).o(1MINI) DEM2.DIST PREP ship , PFV RL-said-COS captain SUBR IRR-test-first-PDIR.YON-3AUGIA be.1MINII .
PFV RL-look.up-GDIR.UP-PDIR.YON Metalo RL-go.up-GDIR.UP-NMLZ.POSS-3MINII , and PFV RL-watch-GDIR.UP needle fish that.one PFV RL-hang-GDIR.UP-still-3MINIS dangling-GDIR.UP-PDIR.YON-3MINII .	PFV RL-look.at-follow-GDIR.UP-COS Metalo NMLZ1-go-GDIR.UP-NMLZ.POSS-3MINII , and watch-PDIR.YON needlefish that.one be.small hang-DSTR-GDIR.UP-COS-also-PDIR.YON .
Ruth Incne SUBR return-GDIR.BACK-3MINII PREP school PFV RL-teach-RL-do.together-COS-EX .	Ruth Incne SUBR return-PDIR.HITHER-3MINIA DEM2.DIST PREP school PFV RL-teach-COS-1AUGI COM.DU .
vowel these PREP time PCLF.B&G Rik Biukan , be.3PL vowel these top-SUPL	vowel these PREP time PCLF.B&G Rik Biukan , head vowel these PAS-spotted-GDIR.DOWN .
and June Iteti RL-replace-COS-3MINII Annie Sade PREP NMLZ1-become-NMLZ.POSS-3FEMII typist PCLF.OUR	and June Iteti exchange-3MINIA Annie Sunday PREP NMLZ1-become-NMLZ.POSS-3MINII typist PCLF.RSBL-1AUGII .
SUBR reach-bz(PDIR.YON).o(1MINI) DEM2.DIST year SUBR one , PFV RL-take-COS SUBR-be.big PREP school be.1MINII PREP NMLZ1-work-NMLZ.POSS-1MINII PREP insides house PCLF.B&G-3MINII PREP year SUBR 1941 .	SUBR reach-bz(PDIR.YON).o(1MINI) DEM2.DIST year SUBR-be.one , PFV RL-take-COS SUBR-be.big GEN1A school be.1MINII PREP NMLZ1-work-NMLZ.POSS-1MINII PREP insides house PCLF.B&G-3MINII PREP year 1941 .
RL-ask-APPL-bz(PDIR.YON).o(1MINI) DAT.3MINII time three , but NEG-TR-hear-NMLZ-NEG all	ask.for-GDIR.IN-APPL-bz(PDIR.YON).o(1MINI)-3MINIA DAT.3MINII time-3MINII three , but NEG-allow-APPL-PDIR.HITHER-3MINIA-NEG all .
house PCLF.PL-be.gone-too .	house finish-INTS-GDIR.DOWN-also-3MINIS .
SUBR be.none DEM2.DIST SUBR see-1MINI and SUBR CAUS-return-PDIR.HITHER-3MINI word-1MINI , PFV RL-come.to-mind-1MINII SUBR DEM2.DIST be.good spirit DEM2.DIST RL-speak-GDIR.IN-bz-3MINIA DAT.1MINII .	SUBR none DEM2.DIST child SUBR see-1MINI and SUBR CAUS-return-PDIR.HITHER-3MINIA word-1MINII , PFV RL-CAUS-take-COS mind-1MINII SUBR spirit good this RL-speak-PDIR.HITHER DAT.1MINII .
but MID-say-PDIR.YON captain SUBR , “ travel-1AUGII-be.able-just-1AUGI mind-1AUGII NEG-transport-NMLZ.POSS-1AUGII be.2MINII PREP be.1AUGII-transport-NMLZ.POSS-1AUGII DAT.2MINII NMLZ1-work-NMLZ.POSS-2MINII a' but come-1AUGII PREP NMLZ1-work-NMLZ.POSS doctor.med .”	but MID-say-PDIR.YON captain SUBR , “ NEG-travel-APPL-PDIR.HITHER-1MINI-NEG here NMLZ1-travel-DPV-INTS-NMLZ.POSS-1MINII be.2MINII PREP NMLZ1-work-NMLZ.POSS-2MINII but travel-APPL-PDIR.HITHER-1MINI NMLZ1-work-NMLZ.POSS doctor.med .”
and PFV RL-say-COS-PDIR.YON-3MINIA NMLZ1-follow-NMLZ.POSS-mind SUBR DAT.3AUGII place.DEM2.DIST	and PFV RL-say-COS-PDIR.HITHER-3MINIA NMLZ1-go-follow-COS-NMLZ.POSS-3MINII place.DEM2.DIST RL-shoot neck-1AUGII .
be.3ᴀᴜɢɪɪ DEM1.PROX-COS only RL-make-3ᴀᴜɢ ᴅᴇᴍ1.ᴘʀᴏx ᴛʜɪɴɢ ᴛʜᴀᴛ ᴡᴇ see-1ᴀᴜɢ ɪɴ world-ᴅᴇᴍ : tree-ᴘʟ , grass-ᴘʟ , vine-ᴘʟ , animal-ᴘʟ , bird-ᴘʟ , fish-ᴘʟ , thing-ᴘʟ ᴛʜᴀᴛ SUBR fly-3ᴀᴜɢ ɪɪ ᴀɴᴅ DEM1.PROX crawl-3ᴀᴜɢ .	be.3MINII only SUBR MID-work-APPL thing all these RL-see-TR-12AUGI-PL PREP world : tree , grass , rope , animal , bird , fish , thing SUBR-3AUG-be.small SUBR 3AUG-fly-DSTR-3AUGIS and SUBR 3AUG-crawl-DSTR-3AUGIS .
so.then a day SUBR , leader GEN1A monk DAT.3MINII say-PDIR.YON-3MINIA Mwekati leader GEN1A village GEN1A Ncnqmz.vil SUBR , “ say-PDIR.YON just PREP Mzdealwx SUBR if want-3MINII thing try-3MINIS have-3MINII or no ?”	so.then a day , SUBR-be.big GEN1A monk MID-say-PDIR.YON-3MINIA PREP Mwekati leader GEN1A village Ncnqmz.vil , SUBR , “ say-PDIR.YON just PREP Mzdealwx , if want mind-3MINII NMLZ1-try-NMLZ.POSS-PDIR.YON-1AUGI a thing SUBR stay-PDIR.HITHER-3MINIS DAT.1AUGII or no ?”
RPRN2-DEM1.DIST-3MINII class one and two .	RPRN2-DEM1.DIST-3MINII-PL class 1 and 2 .
Dckta Foks SUBR turn-path-PDIR.HITHER-3MINIA DEM2.DIST behind PREP hand SUBR give-INTS-PDIR.HITHER-3MINIA umbrella PREP cover-from-APPL-1MINI bag PCLF.HAND-3MINII RL-wear-around.neck-1MINI , side head-3MINII SUBR-left.side PFV RL-bang-GDIR.IN-COS PREP a place SUBR-bent-GDIR.OUT-PDIR.HITHER PREP tree coconut SUBR-bow-GDIR.OUT-PDIR.YON PREP road .	Dckta Foks SUBR turn-path-PDIR.HITHER-3MINIA DEM2.DIST hand , because IRR-give-PDIR.HITHER-3MINIA umbrella SUBR IRR-CAUS-cover.from.rain-APPL-bz(PDIR.YON).o(1MINI) basket PCLF.HAND-3MINII DEM2.DIST RL-live-1MINI , side head-3MINII SUBR-left.side PFV RL-bang-GDIR.IN-COS place bent GEN1A a tree coconut SUBR bow-GDIR.OUT-m PREP road .
and crew PCLF.RSBL-3AUGII-PL be.happy-also , because CONT-go-1AUGI ᴄᴏᴍ.ᴘʟ PREP NMLZ1-work-NMLZ.POSS PREP garden , build-1AUGI house , hunt-1AUGI ᴄᴏᴍ.ᴘʟ PREP dog , trap-1AUGI bird , fish-1AUGI ᴄᴏᴍ.ᴘʟ PREP sea , and dance-1AUGI ᴄᴏᴍ.ᴘʟ PREP dance.ring .	and crew PCLF.RSBL-3AUGII-PL 3AUG-be.happy-also-3AUGIS , because go-always-1AUGI ᴄᴏᴍ.ᴘʟ PREP NMLZ1-work-NMLZ PREP garden , NMLZ1-work-NMLZ house , NMLZ1-MID-go-DPV-NMLZ dog , NMLZ1-lure.fowl-NMLZ chicken , NMLZ1-fish-NMLZ sea and dance-1AUGI ᴄᴏᴍ.ᴘʟ PREP dance.ring .
be.1AUGII SUBR IRR-live-still-3AUGIS there two.ten-be.one-two-3AUGIS be.1AUGII .	be.1AUGII SUBR 3AUG-live-INTS-COS-just ten-two-1AUGII nrade two .
so.then time DEM2.DIST PREP morning , wash-INTS-GDIR.OUT-1MINI eye-1MINII , wear-INTS-1MINI cloth GEN1A Sunday and PFV RL-go-COS-PDIR.YON PREP house PCLF.B&G-3MINII .	so.then today PREP morning , wash-INTS-GDIR.OUT-1MINI eye-1MINII , wear.clothing-INTS-1MINII cloth GEN1A Sunday and PFV RL-go-COS-bz(PDIR.YON).o(1MINI) house PCLF.B&G-3MINII .
mankind four SUBR only PFV-guard-INTS-3MINIP PREP camp PCLF.B&G-1AUGII .	mankind four-just SUBR 3AUG-watch-3AUGIS PREP camp PCLF.B&G-1AUGII .
"PFV RL-MID-say-COS-PDIR.HITHER-3MINIA DAT.1MINII , "" happy-INTS-be.in.pieces-INTS-GDIR.IN work here ?"""	"PFV RL-MID-say-COS-PDIR.HITHER-3MINIA SUBR , "" be.happy-about-2MINI NMLZ1-work-PROP here ?"""
priest Lesile be.3ᴀᴜɢII ᴄᴏᴍ.ᴘʟ four group DEM2.DIST NEG-wait-3MINIA-NEG PREP friend DEM2.DIST PFV RL.3AUG-go-GDIR.DOWN-3AUGIS PREP NMLZ1-drink-NMLZ.POSS-3AUGII water .	priest Lesile be.3ᴀᴜɢII ᴄᴏᴍ.ᴘʟ child those four NEG-NMLZ1-wait-3AUGIA-NEG friend-3AUGII those RL.3AUG-go-GDIR.DOWN-3AUGIS PREP water PREP NMLZ1-drink-NMLZ.POSS-3AUGII .
Be someone DEM3.DIST be.powerful , holy , self-surpass , unseen , and NEG be.able-3MINII PAS-carve-3MINII image-3MINII .	Be.god be.3MINII mankind SUBR powerful , holy , CAUS-surpass REFL , NEG-PAS-see-NEG and none SUBR IRR-MID-carve.wood image-3MINII .
book DEM1.DIST-3MINII be.3ᴀᴜɢII they.here , book GEN1A holy.writings DEM2.DIST afterward-3MINIS and Psalm , book GEN1A worship , and book GEN1A holy.song .	book those be.3ᴀᴜɢII they.here , book GEN1A holy.writings DEM2.DIST afterward-3MINIS , book GEN1A NMLZ1-worship-NMLZ , and book GEN1A song-SUBR-holy .
chapter DEM2.DIST six-be.one	chapter DEM2.DIST six
stay-GDIR.UP-also-PDIR.YON bird GEN1A sea and bush , and stay-GDIR.UP-also-PDIR.YON fish GEN1A sea and animal GEN1A bush .	stay-GDIR.UP-also-PDIR.YON-3MINIS bird GEN1A sea and bush , and stay-GDIR.UP-also-PDIR.YON-3MINIS tree GEN1A sea and animal GEN1A bush .
but reach-PDIR.HITHER-3AUGII DEM1.DIST COM.DU PFV RL-be.new-3AUGIS .	but reach-PDIR.HITHER-3MINIA time DEM2.PROΧ PFV RL.3AUG-new-still-3AUGIS .
NMLZ1-see-NMLZ.POSS-1MINII time DEM2.DIST work church and companions go-true-very .	NMLZ1-see-NMLZ.POSS-1MINII-3MINIA time those NMLZ1-work-NMLZ.POSS church.building and companions go-really-INTS .
begin-GDIR.IN-1MINI NMLZ1-work-NMLZ PREP January 1949 .	begin-GDIR.IN-1MINI NMLZ1-work-NMLZ PREP January 1949 .
NMLZ1-see-NMLZ.POSS-PDIR.YON-1AUGI Tangtalau week three and be.1AUGII ᴄᴏᴍ.ᴘʟ bishop DEM2.DIST RL-go-GDIR.DOWN-COS-1AUGI PREP sea and be.1AUGII stay-APPL-3MINII village name-3MINII Fiu .	be-TR-INTS-just-1AUGI Tangtalau week three and be.1AUGII ᴄᴏᴍ.ᴘʟ bishop DEM2.DIST RL-go-GDIR.DOWN-COS-1AUGI sea RL-be-COS-1AUGI PREP a village name-3MINII Fiu.vil .
but MID-say-PDIR.YON-1AUGI PREP priest IRR-go-GDIR.HITHER-3MINIS be.1AUGII , so come-APPL-3MINIS be.1AUGII PREP MIDST-1AUGII people those GEN1A	but MID-say-PDIR.YON-1AUGI DAT.3MINII IRR-go-DPV-PDIR.YON-3MINIA be.1AUGII , PFV RL-go-DPV-GDIR.IN-COS-PDIR.YON-3MINIA be.1AUGII PREP midst people those .
group those PREP priest Lesile those 3AUG-go-3AUGIS and PFV RL-descend-COS-3AUGIS DEM2.DIST flat	group-3MINII DEM2.DIST PREP priest Lesile 3AUG-go-3AUGIS and PFV RL.3AUG-go-GDIR.DOWN-COS-3AUGIS place flat .
RL-run-INTS-1PLU PAS-throw-GDIR.DOWN-REFL-APPL-1PLU PREP base cross DEM2.DIST .	3AUG-hurry-GDIR.IN-3AUGIS 3AUG-throw-GDIR.DOWN-REFL-3AUGIS PREP base cross DEM2.DIST .
PREP back.part-3MINII , SUBR-be.big-DIST RL-call-INTS-3AUGII those two RL-go-INTS-1AUGI ᴄᴏᴍ.ᴘʟ ᴄᴏᴍ.ᴘʟ ᴄʀᴇᴅ.ᴅᴏ ᴄᴏᴍ.ᴘʟ ᴘʀᴏᴍᴇ-2ᴀᴜɢ ᴅᴇᴍᴏɴ ᴘʀᴀʏ-ᴘʟᴜ-ᴘᴅɪʀ.ʏᴏɴ-3ᴀᴜɢ ᴘʀᴇᴘ ᴄᴏᴍ.ᴘʟ ᴍᴏᴜᴛʜ-ᴘʟᴜ-ᴘᴅɪʀ.ʏᴏɴ-3ᴀᴜɢ ᴏғ ᴍᴏᴜᴛʜ-ᴘʟᴜ-ᴘᴅɪʀ.ʏᴏɴ-3ᴀᴜɢ ᴍᴏᴜᴛʜ-ᴘʟᴜ-ᴘᴅɪʀ.ʏᴏɴ-3ᴀᴜɢ ᴍᴏᴜᴛʜ-ᴘʟᴜ-ᴘᴅɪʀ.ʏᴏɴ-3ᴀᴜɢ ᴍᴏᴜᴛʜ-ᴘʟᴜ-ᴘᴅɪʀ.ʏᴏɴ-3ᴀᴜɢ ᴍᴏᴜᴛʜ-ᴘʟᴜ-ᴘᴅɪʀ.ʏᴏɴ-3ᴀᴜɢ ᴍᴏᴜᴛʜ-ᴘʟᴜ-ᴘᴅɪʀ.ʏᴏɴ-3ᴀᴜɢ ᴍᴏᴜᴛʜ-ᴘʟᴜ-ᴘᴅɪʀ.ʏᴏɴ-3ᴀᴜɢ ᴍᴏᴜᴛʜ-ᴘʟᴜ-ᴘᴅɪʀ.ʏᴏɴ-3ᴀᴜɢ ᴍᴏᴜᴛʜ-ᴘʟᴜ-ᴘᴅɪʀ.ʏᴏɴ-3ᴀᴜɢ ᴍᴏᴜᴛʜ-ᴘʟᴜ-ᴘᴅɪʀ.ʏᴏɴ-3ᴀᴜɢ ᴍᴏᴜᴛʜ-ᴘʟᴜ-ᴘᴅɪʀ.ʏᴏɴ-3ᴀᴜɢ ᴍᴏᴜᴛʜ-ᴘʟᴜ-ᴘᴅɪʀ.ʏᴏɴ-3ᴀᴜɢ ᴍᴏᴜᴛʜ-ᴘʟᴜ-ᴘᴅɪʀ.ʏᴏɴ-3ᴀᴜɢ ᴍᴏᴜᴛʜ-ᴘʟᴜ-ᴘᴅɪʀ.ʏᴏɴ-3ᴀᴜɢ ᴍᴏᴜᴛʜ-ᴘʟᴜ-ᴘᴅɪʀ.ʏᴏɴ-3ᴀᴜɢ ᴍᴏᴜᴛʜ-ᴘʟᴜ-ᴘᴅɪʀ.ʏᴏɴ-3ᴀᴜɢ ᴍᴏᴜᴛʜ-ᴘʟᴜ-ᴘᴅɪʀ.ʏᴏɴ-3ᴀᴜɢ ᴍᴏᴜᴛʜ-ᴘʟᴜ-ᴘᴅɪʀ.ʏᴏɴ-3ᴀᴜɢ ᴍᴏᴜᴛʜ-ᴘʟᴜ-ᴘᴅɪʀ.ʏᴏɴ-3ᴀᴜɢ ᴍᴏᴜᴛʜ-ᴘʟᴜ-ᴘᴅɪʀ.ʏᴏɴ-3ᴀᴜɢ ᴍᴏᴜᴛʜ-ᴘʟᴜ-ᴘᴅɪʀ.ʏᴏɴ-3ᴀᴜɢ ᴍᴏᴜᴛʜ-ᴘʟᴜ-ᴘᴅɪʀ.ʏᴏɴ-3ᴀᴜɢ ᴍᴏᴜᴛʜ-ᴘʟᴜ-ᴘᴅɪʀ.ʏᴏɴ-3ᴀᴜɢ ᴍᴏᴜᴛʜ-ᴘʟᴜ-ᴘᴅɪʀ.ʏᴏɴ-3ᴀᴜɢ ᴍᴏᴜᴛʜ-ᴘʟᴜ-ᴘᴅɪʀ.ʏᴏɴ-3ᴀᴜɢ ᴍᴏᴜᴛʜ-ᴘʟᴜ-ᴘᴅɪʀ.ʏᴏɴ-3ᴀᴜɢ ᴍᴏᴜᴛʜ-ᴘʟᴜ-ᴘᴅɪʀ.ʏᴏɴ-3ᴀᴜɢ ᴍᴏᴜᴛʜ-ᴘʟᴜ-ᴘᴅɪʀ.ʏᴏɴ-3ᴀᴜɢ ᴍᴏᴜᴛʜ-ᴘʟᴜ-ᴘᴅɪʀ.ʏᴏɴ-3ᴀᴜɢ ᴍᴏᴜᴛʜ-ᴘʟᴜ-ᴘᴅɪʀ.ʏᴏɴ-3ᴀᴜɢ ᴍᴏᴜᴛʜ-ᴘʟᴜ-ᴘᴅɪʀ.ʏᴏɴ-3ᴀᴜɢ ᴍᴏᴜᴛʜ-ᴘʟᴜ-ᴘᴅɪʀ.ʏᴏɴ-3ᴀᴜɢ ᴍᴏᴜᴛʜ-ᴘʟᴜ-ᴘᴅɪʀ.ʏᴏɴ-3ᴀᴜɢ ᴍᴏᴜᴛʜ-ᴘʟᴜ-ᴘᴅɪʀ.ʏᴏɴ-3ᴀᴜɢ ᴍᴏᴜᴛʜ-ᴘʟᴜ-ᴘᴅɪʀ.ʏᴏɴ-3ᴀᴜɢ ᴍᴏᴜᴛʜ-ᴘʟᴜ-ᴘᴅɪʀ.ʏᴏɴ-3ᴀᴜɢ ᴍᴏᴜᴛʜ-ᴘʟᴜ-ᴘᴅɪʀ.ʏᴏɴ-3ᴀᴜɢ ᴍᴏᴜᴛʜ-ᴘʟᴜ-ᴘᴅɪʀ.ʏᴏɴ-3ᴀᴜɢ ᴍᴏᴜᴛʜ-ᴘʟᴜ-ᴘᴅɪʀ.ʏᴏɴ-3ᴀᴜɢ ᴍᴏᴜᴛʜ-ᴘʟᴜ-ᴘᴅɪʀ.ʏᴏɴ-3ᴀᴜɢ ᴍᴏᴜᴛʜ-ᴘʟᴜ-ᴘᴅɪʀ.ʏᴏɴ-3ᴀᴜɢ ᴍᴏᴜᴛʜ-ᴘʟᴜ-ᴘᴅɪʀ.ʏᴏɴ-3ᴀᴜɢ ᴍᴏᴜᴛʜ-ᴘʟᴜ-ᴘᴅɪʀ.ʏᴏɴ-3ᴀᴜɢ ᴍᴏᴜᴛʜ-ᴘʟᴜ-ᴘᴅɪʀ.ʏᴏɴ-3ᴀᴜɢ ᴍᴏᴜᴛʜ-ᴘʟᴜ-ᴘᴅɪʀ.ʏᴏɴ-3ᴀᴜɢ ᴍᴏᴜᴛʜ-ᴘʟᴜ-ᴘᴅɪʀ.ʏᴏɴ-3ᴀᴜɢ ᴍᴏᴜᴛʜ-ᴘʟᴜ-ᴘᴅɪʀ.ʏᴏɴ-3ᴀᴜɢ ᴍᴏᴜᴛʜ-ᴘʟᴜ-ᴘᴅɪʀ.ʏᴏɴ-3ᴀᴜɢ ᴍᴏᴜᴛʜ-ᴘʟᴜ-ᴘᴅɪʀ.ʏᴏɴ-3ᴀᴜɢ ᴍᴏᴜᴛʜ-ᴘʟᴜ-ᴘᴅɪʀ.ʏᴏɴ-3ᴀᴜɢ ᴍᴏᴜᴛʜ-ᴘʟᴜ-ᴘᴅɪʀ.ʏᴏɴ-3ᴀᴜɢ ᴍᴏᴜᴛʜ-ᴘʟᴜ-ᴘᴅɪʀ.ʏᴏɴ-3ᴀᴜɢ ᴍᴏᴜᴛʜ-ᴘʟᴜ-ᴘᴅɪʀ.ʏᴏɴ-3ᴀᴜɢ ᴍᴏᴜᴛʜ-ᴘʟᴜ-ᴘᴅɪʀ.ʏᴏɴ-3ᴀᴜɢ ᴍᴏᴜᴛʜ-ᴘʟᴜ-ᴘᴅɪʀ.ʏᴏɴ-3ᴀᴜɢ ᴍᴏᴜᴛʜ-ᴘʟᴜ-ᴘᴅɪʀ.ʏᴏɴ-3ᴀᴜɢ ᴍᴏᴜᴛʜ-ᴘʟᴜ-ᴘᴅɪʀ.ʏᴏɴ-3ᴀᴜɢ ᴍᴏᴜᴛʜ-ᴘʟᴜ-ᴘᴅɪʀ.ʏᴏɴ-3ᴀᴜɢ ᴍᴏᴜᴛʜ-ᴘʟᴜ-ᴘᴅɪʀ.ʏᴏɴ-3ᴀᴜɢ ᴍᴏᴜᴛʜ-ᴘʟᴜ-ᴘᴅɪʀ.ʏᴏɴ-3ᴀᴜɢ ᴍᴏᴜᴛʜ-ᴘʟᴜ-ᴘᴅɪʀ.ʏᴏɴ-3ᴀᴜɢ ᴍᴏᴜᴛʜ-ᴘʟᴜ-ᴘᴅɪʀ.ʏᴏɴ-3ᴀᴜɢ ᴍᴏᴜᴛʜ-ᴘʟᴜ-ᴘᴅɪʀ.ʏᴏɴ-3ᴀᴜɢ ᴍᴏᴜᴛʜ-ᴘʟᴜ-ᴘᴅɪʀ.ʏᴏɴ-3ᴀᴜɢ ᴍᴏᴜᴛʜ-ᴘʟᴜ-ᴘᴅɪʀ.ʏᴏɴ-3ᴀᴜɢ ᴍᴏᴜᴛʜ-ᴘʟᴜ-ᴘᴅɪʀ.ʏᴏɴ-3ᴀᴜɢ ᴍᴏᴜᴛʜ-ᴘʟᴜ-ᴘᴅɪʀ.ʏᴏɴ-3ᴀᴜɢ ᴍᴏᴜᴛʜ-ᴘʟᴜ-ᴘᴅɪʀ.ʏᴏɴ-3ᴀᴜɢ ᴍᴏᴜᴛʜ-ᴘʟᴜ-ᴘᴅɪʀ.ʏᴏɴ-3ᴀᴜɢ ᴍᴏᴜᴛʜ-ᴘʟᴜ-ᴘᴅɪʀ.ʏᴏɴ-3ᴀᴜɢ ᴍᴏᴜᴛʜ-ᴘʟᴜ-ᴘᴅɪʀ.ʏᴏɴ-3ᴀᴜɢ ᴍᴏᴜᴛʜ-ᴘʟᴜ-ᴘᴅɪʀ.ʏᴏɴ-3ᴀᴜɢ ᴍᴏᴜᴛʜ-ᴘʟᴜ-ᴘᴅɪʀ.ʏᴏɴ-3ᴀᴜɢ ᴍᴏᴜᴛʜ-ᴘʟᴜ-ᴘᴅɪʀ.ʏᴏɴ-3ᴀᴜɢ ᴍᴏᴜᴛʜ-ᴘʟᴜ-ᴘᴅɪʀ.	PREP back.part-3MINII , SUBR-be.big GEN1A monk those call.someone-3MINIA AT.ΦNT.PL be.1AUGII those RL.3AUG-MID-obey-3AUGIS , go-PDIR.YON-1AUGI PFV RL-enter.in-COS-PDIR.YON-1AUGI ᴄᴏᴍ.ᴘʟ PREP NMLZ1-pray-NMLZ-PDIR.YON PREP Mzdealwx .
"MID-say-PDIR.HITHER SUBR-be.big GEN1A-1AUGII priest Wili SUBR , "" who 3AUG-want neck-3AUGII NMLZ1-go-3AUGIS , IRR-go-3AUGIS , but be.1MINII only PFV-stay-INTR-1MINII here ."""	"MID-say-PDIR.HITHER SUBR-be.big GEN1A-1AUGII priest Wili SUBR , "" who 3AUG-want neck-3AUGII NMLZ1-go-APPL , IRR-go-3AUGIS , but be.1MINII IRR-be-INTS-PDIR.HITHER-1MINI here ."""
NMLZ1-do-APPL time be.schooled ᴄᴏᴍ-begin-NMLZ1 man DEM3.DIST work-NMLZ1 money .	NMLZ1-work-much-NMLZ.POSS-1AUGII PREP school , be.like-1AUGI mankind SUBR 3AUG-serve-3AUGIS money .
"PFV RL-MID-say-TR priest DEM2.DIST SUBR , "" be.2AUGII Anglican and be.1AUGII Catholic , time DEM2.DIST ᴄᴏᴍ.ᴘʟ RL-pray-APPL-1AUGII PREP church.building PREP morning and evening , pray-APPL-2AUGII-house DEM2.PROΧ sleep-APPL-2AUGII ."	"PFV RL-said-COS priest DAT.1AUGII SUBR , "" be.2AUGII Anglican and be.1AUGII Catholic , time DEM2.DIST RL-pray-APPL-1AUGII PREP church.building PREP morning and evening , pray-also-2AUGI house DEM2.PROΧ RL-sleep-APPL-2AUGI ."
and be.like-1MINI tight-shut-TR-GDIR.IN-1MINI .	and eye-1MINII CAUS-sleep-INTS-GDIR.IN-just-1MIN.CMB .
so.then PCLF.HAND tqvope-3MINII kz Reef.Is .	so.then PFV RL-travel-COS-3MINIS also Reef.Is .
and PFV RL-motor-GDIR.OUT-COS-3MINII Aijz leave-3MINII it float-APPL-3SNG.ABS far .	and PFV RL.3AUG-travel-away.from-COS-3AUGIA Aijz RL-float-GDIR.IN-COS-PDIR.YON far .
and PFV RL-jump-GDIR.DOWN-INTS-quickly-COS sea .	and jump-fast-INTS-GDIR.DOWN-1MINI sea .
field manioc DEM2.DIST also have-3MINII pineapple and plant-TR-CMPL-3MINII therein .	field manioc DEM2.DIST PAS-plant-TR also those therein pineapple .
EP 24 . Mzdealwx confess-INTS-GDIR.IN-3MINI god NMLZ1-believe-NMLZ.POSS-3MINI	24 . Mzdealwx confess-3MINIA NMLZ1-believe-NMLZ.POSS-3MINII god
thank-GDIR.IN-1AUGII PREP god , and DEM2.DIST RL-peel-COS-3AUGIA and RL-eat-COS-3AUGI .	thank-INTS-APPL-PDIR.YON-1AUGI PREP god , and be.1AUGII DEM2.DIST RL-MID-peel-COS-1AUGI and RL-eat-COS-1AUGI .
want work-GDIR.IN book these four IRR-finish-APPL-3AUGII be.3AUGII SUBR-be.one .	want neck-1AUGII book these four NMLZ1-finished-NMLZ.POSS-PDIR.YON-3AUGIA time SUBR-be.one .
that house stand-3AUG PREP side GEN1A river DEM2.DIST	house there stand-INTS-GDIR.OUT PREP side GEN1A river .
1AUGPL-begin-GDIR.IN-1AUGPL school PREP moon October PREP year 1943 .	begin-GDIR.IN-1AUGI NMLZ1-be.schooled-NMLZ PREP moon October 1943 .
SUBR think-TR mind-1MINII dream SUBR-MID-see-TR-NMLZ.POSS-1MINII DEM2.DIST , PFV RL-ask-COS-1MINI PREP manager GEN1A Society Jason Melzk SUBR-go-TR-NMLZ.POSS-1MINI .	SUBR think-TR mind-1MINII NMLZ1-MID-dream-NMLZ.POSS-1MINII DEM2.DIST , PFV RL-ask.for-GDIR.IN-COS-bz(PDIR.YON).o(1MINI) PREP manager GEN1A Society , Jason Melzk , NMLZ1-go-GDIR.OUT-NMLZ.POSS-1MINII .
so.then be.1MINII DEM2.DIST RL-come-COS-1MINI PREP ship.	so.then be.1MINII DEM2.DIST RL-work-COS-1MINI PREP ship .
NMLZ1-work-NMLZ.POSS-1MINII PREP NMLZ1-MID-exchange-NMLZ-1MINII holy.writings SUBR-new PREP Natqgu SUBR very big-very-very DEM2.DIST SUBR ask-RL.3AUG-1MINI PREP Sanders DEM1.PROX finish-bz(PDIR.YON).o(1MINI) SUBR-CAUS-go-peace .	NMLZ1-work-NMLZ.POSS-1MINII PREP NMLZ1-MID-exchange-NMLZ Nzryrngrkxtr PREP Natqgu SUBR be.big-much-3MINIA DEM2.DIST , PFV RL-ask.for-COS-bz(PDIR.YON).o(1MINI) PREP Sadas IRR-finished-NMLZ.POSS-1MINII PREP NMLZ1-become-NMLZ.POSS-1MINII peacemaker .
MID-two-APPL-3AUGII PFV RL.3AUG-have-3AUGIS first child 3AUG-four-3AUGIS .	PCLF.RSBL-3AUGII MID-two-APPL-3AUGII child 3AUG-four-3AUGIS .
rope PCLF.ASSOC-3MINII be.lying-GDIR.UP-PDIR.HITHER PREP roof house , and be bait hook needlefish .	"rope PCLF.ASSOC fish.hook PCLF.HAND-3MINII PFV RL-lying.down-GDIR.DOWN-PDIR.HITHER there wq PREP back.part house , and be bait GEN1A fish.hook PCLF.HAND-3MINII needlefish ."""
talk-3AUGIS there and agree-3AUGIS DEM2.DIST same PREP leave-TR-NMLZ.POSS village PCLF.B&G-3AUGII	3AUG-speak-GDIR.IN-3AUGIS therein and mind-3AUGII be.one-TR SUBR IRR-leave-COS-3AUGIA village PCLF.B&G-3AUGII .
school DEM2.DIST HAB-school-APPL-3MINIP child GEN1A day , but NEG-sleep-1AUGII therein , and child be.mixed , child DEM2.DIST and child wife .	school DEM1.DIST IRR-be.schooled-INTS-APPL-just child daylight , but NEG-IRR-sleep-NEG therein , and child IRR-mix-3AUGIS , child mankind and child female .
travel-back-1AUGI Veranaaso friend-1AUGII PREP Fiu , Tangarare and Tzlede PFV RL-be-there-3AUGII , but NEG-PFV-begin-school-3AUGII .	travel-PDIR.YON-1AUGI Veranaaso friend-1AUGII those Fiu.vil , Tzngarare and Tzlede PFV RL.3AUG-be-COS-3AUGIS therein , but NEG-3AUG-be.schooled-not.yet-3AUGIS .
SUBR see-1MINI NMLZ1-bring-NMLZ.POSS-3MINII stick GEN1A DEM2.PROX cry-1MINI and PFV RL-MID-say-COS-PDIR.YON-1MINI DAT.3MINII SUBR , “ father , enter-1AUGP mankind DEM2.PROX cry-1MINI because NEG-say-1MINII DAT.1AUGII DEM2.PROX enter-APPL doorway DEM2.PROX PAS-restrict-APPL NMLZ1-jump-GDIR.IN-NMLZ therein therein .”	SUBR see-PDIR.HITHER-1MINI NMLZ1-take-NMLZ.POSS-PDIR.HITHER-3MINIA branch tree DEM2.DIST , be.1MINII DEM2.DIST RL-cry-COS-1MINI and RL-MID-say-COS-bz(PDIR.YON).o(1MINI) DAT.3MINII SUBR , “ father , jump-GDIR.IN-1AUGI PREP doorway DEM2.DIST because NEG-say-PDIR.HITHER-2MINI-NEG DAT.1AUGII SUBR doorway DEM2.DIST PAS-restrict-APPL NMLZ1-jump-GDIR.IN-NMLZ.POSS-1AUGII therein .”
PREP back.part-3MINII , CONJ know-3AUGII 3AUG-do-PDIR.YON-3AUG SUBR-3AUG-be.big NMLZ1-1AUGII-PL image demon REL hand-3MINII RL-CAUS-break-3MINII and REL jump-through-APPL-TR-3AUGII-PL lie-together-3AUGII , and NMLZ1-food.parcel-GEN1A hog.plum.fruit two IRR-abandon-3AUGII , PFV RL.3AUG-say-3AUGII DAT.1AUGII about.	PREP back.part-3MINII , SUBR 3AUG-know-TR SUBR-3AUG-be.big GEN1A-1AUGII-PL image demon DEM2.DIST PCLF.DRINK-3MINII RL-CAUS-broken.stick.like.obj-PDIR.YON-1AUGI and RPRN2.DEM4.PL RL-jump-go.through-1AUGI-PL RL.3AUG-lying.down-TR-together-3AUGIS , and NMLZ1-food.parcel-NMLZ hog.plum.fruit those two RL-jump-away.from-1AUGI , PFV RL.3AUG-speak-APPL-COS-PDIR.HITHER-3AUGIA DAT.1AUGII .
PFV RL-say-COS-PDIR.YON priest Lesile DEM2.DIST one PREP NMLZ1-go.up-APPL but NEG-3AUG-happen-3AUGII because all too weak-INTS-3AUGII .	PFV RL-MID-say-COS-PDIR.YON priest Lesile SUBR IRR-climb INDF.SG be.3ᴀᴜɢII , but none because 3AUG-weak-together-3AUGIS .
time that write-APPL-1AUGII PREP vowel DEM2.DIST PREP head spotted GEN1A-3PLII .	time DEM1.DIST MID-write-1AUGI PREP vowel DEM2.DIST CMPL RL.3AUG-spotted-GDIR.DOWN head-3MINII .
place many SUBR meet-APPL-1AUGII DEM2.DIST group GEN1A people REL work PREP road .	place many SUBR meet-APPL-1AUGII group people SUBR 3AUG-work-3AUGIS PREP road .
and time there-just rain RL-fall-INTS-be.hard Sunday , go-PDIR.YON wind and lightning and thunder , hear-PDIR.YON-1AUGI whistle blow-TR-GDIR.OUT .	and time there-just RL-fall-much-APPL rain , wind , lightning and thunder , hear-PDIR.YON-1AUGI whistle cry-COS also .
want mind-1MINI IRR-tell-APPL-3MINIA therein see-1MINI SUBR and must-hear-1AUGII DAT.3MINII	want mind-1MINII IRR-tell-TR-PDIR.HITHER-3MINIA thing-DEM2.DIST see-1MINI DAT.12AUGII and IRR-listen-PDIR.YON-12AUGI DAT.3MINII .”
but man only kill-3AUGIS DAT.3AUGII people REL-see-3AUGIS	but mankind MID-kill-COS-3MINIS people SUBR PAS-see-INTS-just .
shine-TR-GDIR.DOWN-1MINI torchlight PREP DEM2.DIST small pool sand beach .	CAUS-MID-shine-INTS-GDIR.DOWN-bz(PDIR.YON).o(1MINI) torchlight DEM2.DIST PREP a pool SUBR-be.small-INTS PREP insides sand .
village PCLF.B&G-1AUGII Narnztilolx.vil , village DEM2.DIST extremely.good and beautiful-3MINII .	village PCLF.B&G-1AUGII Narnztilolx.vil , village DEM2.DIST extremely.good and eye-3MINII clear .
NMLZ1-walk-NMLZ.POSS there PREP war-hidden SUBJ-MID-cease-3MINIA time DEM2.PROΧ COM but PFV RL-go-3MINIA	NMLZ1-walk-NMLZ there PREP war-hidden NEG-stop-COS-NEG reach-PDIR.HITHER-3MINIA time DEM2.PROΧ and PCLF.HAND RL-go-still .
PREP NMLZ1-ORD-two time DEM2.DIST once.again go-APPL-PDIR.YON monk , join-APPL-1AUGI ᴄᴏᴍ.ᴘʟ DEM2.DIST NMLZ1-go-NMLZ.POSS-3AUGII .	PREP time-3MINII ORD-two SUBR 3AUG-go.out-APPL again monk , enter.in-bz(PDIR.YON).o(1MINI) ᴄᴏᴍ.ᴘʟ PREP NMLZ1-go-NMLZ.POSS-3AUGII .
doctor and captain GEN1A Nea , 3AUG-be.happy-about-3AUGIA because those 3AUG-be.big SUBR-3AUG-go-INTS-GDIR.TO-3MINII ᴄᴏᴍ.ᴘʟ 3AUG-converse-ᴄᴏᴍ.ᴘʟ-3MINII PREP .	NMLZ1-be-NMLZ.POSS doctor.med and captain Nea.vil , 3AUG-be.happy-about-3AUGIA because SUBR-3AUG-be.big GEN1A-1AUGII-PL 3AUG-go-always-PDIR.YON-3AUGIS DAT.3AUGII PREP NMLZ1-tell-NMLZ.POSS-3AUGII ᴄᴏᴍ.ᴘʟ .
48 . letter.note ORD-two SUBR PAS-write-PDIR.YON PREP mountain Tzlede and go-NMLZ.POSS-3MINIS Tzngarare	48 . letter.note ORD-two SUBR PAS-write-PDIR.YON PREP mountain Tzlede and NMLZ1-go-APPL Tzngarare
said-again-PDIR.YON John SUBR , “ king.tree.PL DAT.1MINII SUBR big son-PL-1MINPOSS you tell-PAST-2AUGII me about NEG-know-PAST-1PLII , NEG-speak-PAST-1PLII with DEM2.PROX yet , and NEG-travel-PAST-3MINII with NEUTRAL.PL yet .	said-again-PDIR.YON John SUBR , “ son-2MINII DEM1.PROΧ-PL be.big RL-say-mq(PDIR.HITHER).q(2MINI) DAT.1MINII NEG-know-not.yet-1AUGI be.3ᴀᴜɢII , NEG-speak-not.yet-1AUGI ᴄᴏᴍ.ᴘʟ and NEG-walk-not.yet-1AUGI ᴄᴏᴍ.ᴘʟ .
krlc thing-RL.say-1MINI , SUBR DEM2.DIST SUBR you NMLZ1-call-MID-1MINII DEM1.DIST only be.him exclusively in whatever thing.bad happen-3MINII	RPRN2-DEM1.DIST RL-say-APPL-bz(PDIR.YON).o(1MINI)-3MINIA , SUBR name SUBR IRR-call-only be.3MINII DEM1.DIST only.one PREP thing bad SUBR happen .
PFV RL-say-COS-bz(PDIR.YON).o(1MINI) DAT.3FSUP SUBR IRR-go-INTS-bz(PDIR.UP).o(1MINI) ᴄᴏᴍ.ᴘʟ bush	PFV RL-MID-say-COS-bz(PDIR.YON).o(1MINI) DAT.3MINII SUBR IRR-go-GDIR.UP-bz(PDIR.YON).o(1MINI) bush .
but NEG-allow-APPL-PDIR.HITHER-3MINIA-NEG .	but NEG-allow-APPL-PDIR.HITHER-3MINIA-NEG .
for year eight PREP NMLZ1-become-NMLZ.POSS-1MINII SUBR-CAUS-go-peace .	work-1MINI year eight PREP NMLZ1-become-NMLZ.POSS-1MINII peacemaker .
SUBR IRR-find-3PLUPOST DEM2.DIST TPNYM Japan SUBR 3AUG-see-3PLU school , PFV RL.3PLU-go-3PLU PREP road REL go-to-3MINIS village DEM2.DIST Maravovo .	SUBR none DEM2.DIST TPNYM Japan SUBR 3AUG-see-3AUGII PREP school , PFV RL.3AUG-go-along-COS-3AUGIA road DEM2.DIST RL-go-path-3MINIA village Maravovo .
be.1AUGII baptize-APPL-PDIR.YON-1AUGI PREP DEM2.DIST house GEN1A monk	baptised-1AUGI outside PREP house PCLF.B&G monk .
leader GEN1A be.schooled DEM2.DIST , priest Sevenoclock , go-with-3MINIS be.1AUGII PREP a house NMLZ1-sleep-NMLZ SUBR empty and	SUBR-be.big GEN1A school DEM2.DIST , priest Sevenoklok , go-DPV-GDIR.IN-3MINIA be.1AUGII PREP a house GEN1A NMLZ1-sleep-NMLZ SUBR be.empty-3MINIS .
so.then AT.ΦNT.SG RL-do-INTS-3MINIA thing DEM2.DIST REL SUBR bad-very-3MINIA so.that IRR-leave-1SG	so.then PFV RL-do-COS-1MINI DEM2.DIST thing SUBR NEG-be.good-NEG SUBR IRR-leave-APPL-1MINII .
and PCLF.B&G-1AUGII want-APPL-1AUGII die ᴄᴏᴍ.ᴘʟ cry-NMLZ-GEN1A .	and be.1AUGII IRR-die-COS-APPL-1AUGII crying .
but do-NEG-much-1AUGII because SUBR DEM2.DIST MID-encourage-APPL-3AUGII .	but NEG-mourn-INTS-much-1AUGI because leader DEM2.DIST RL-CAUS-hot-GDIR.IN-PDIR.HITHER-3MINIA neck-1AUGII .
GEN1A-3MINII house all PFV RL-uproot-GDIR.OUT-INTS-3MINIA sea .	house GEN1A-3MINII-PL pull.out-INTS-GDIR.OUT-them sea all .
so.then one more person declare-REFL-bz(PDIR.YON).o(3MINII) DEM2.DIST , and DEM2.DIST SUBR six PFV very difficult because fear-INTS-1PL lr Japan very much .	so.then declare-REFL again DEM2.DIST be.one , and SUBR six PFV RL-be.difficult-INTS-COS because fear-TR-much-1AUGI lr Japan .
"hear-bz(PDIR.YON).o(1MINI) Mcnika MID-say-COS-PDIR.HITHER-3MINIA SUBR , "" father , LOC Jesus DEM2.DIST RL-call-3MINIS time DEM2.DIST RL-cry-TR-APPL-2MINII ?"""	"hear-bz(PDIR.YON).o(1MINI) Mcnika MID-say-COS-PDIR.HITHER-3MINIA DAT.1MINII SUBR , "" dadi , where Jesus DEM2.DIST RL-call.someone-2MINI today time DEM2.DIST RL-cry-APPL-1MINII ?"""
every Sunday Sade DEM2.DIST 3AUG-come-INTS Dckta Fox PREP NMLZ1-CAUS-eat-SUBR-holy-NMLZ.POSS-3MINII , bring-TR-INTS-3MINII child be.one-3AUGII .	always PREP Sunday those RL-go-APPL-PDIR.HITHER doctor.med Fox here PREP NMLZ1-CAUS-eat-SUBR-holy-NMLZ.POSS-3MINII , RL-MID-go-DPV-just-PDIR.HITHER-3MINIS person SUBR-be.one .
PREP NMLZ1-go-NMLZ.POSS-1AUGII DEM2.DIST river , SUBR-be.big PFV RL-shoot-GDIR.DOWN-3MINII three Japanese .	PREP NMLZ1-go-along-GDIR.DOWN-NMLZ.POSS-1AUGII DEM2.DIST water , SUBR-be.big GEN1A-1AUGII shoot-PDIR.YON-3MINIA Japan three .
chapter DEM2.DIST three	chapter DEM2.DIST three
Joseph SUBR be.rest-GDIR.IN SUBR DEM2.DIST PREP hospital , captain SUBR MID-say-PDIR.HITHER-1MINI DAT.1MINII SUBR should-also take-GDIR.UP-COS-1MINI POSS.SUBR-work Joseph	Joseph SUBR lying.down-3MINIA DEM2.DIST PREP hospital PFV RL-MID-say-COS-PDIR.HITHER captain DAT.1MINII IRR-take-COS-also-1MINI NMLZ1-work-NMLZ.POSS Joseph .
be.good PFV RL-return-again-PDIR.YON-3AUG .	be.good PFV RL.3AUG-return-COS-again-PDIR.HITHER-3AUGIS .
but be.afraid-TR-INTS-1AUGII all 1AUG	but fear-1AUGI all APPL-1AUGII .
brother those take-PDIR.YON equal.piece break-INTS-3MINIA ᴄᴏᴍ.ᴘʟ be.equal-APPL-3AUGII	take.hold.of-TR-PDIR.YON monk DEM2.DIST break-INTS-3MINII piece-3MINII two equal-APPL .
together-assemble-TR-1AUGI GEN1A-3MINII-PL PREP NMLZ1-take-NMLZ.POSS-1AUGII .	gather-together-1AUGI house PCLF.B&G-1AUGII ᴄᴏᴍ.ᴘʟ .
