predicted_glosses	glosses
« 1SG.ABS », say-AOR , « go-AOR among person-PL-GEN between-INESS enter-FUT-FUT , look-HORT maybe 1SG.GEN fate-INESS cop . »	« 1sg.abs », say-AOR , « go-AOR man-ERG-GEN between-INESS enter.FUT-FUT , look.HORT maybe 1sg.gen fate-INESS cop .»
decision one be-PST-SBST	agreement-PL one was .
« And.but 1pl.abs them-ERG-GEN to return-INF want-ENT , come group be-AOR go.back.HORT 1pl.abs .»	« And.but 1pl.abs them-ERG-GEN to returned-AOR want-ENT , come group happened-AOR go.back.HORT 1pl.abs .»
what love cop , ashuq boy	love what was , ashuq boy ?
what-ERG-DAT , where be-AOR ?	what-DAT , where be-AOR ?
good many say-AOR-PTP , happen-AOR , 1pl.abs event-INESS-SPSS agree-AOR-PTP .	good toasts-PL say-AOR , agreements-PL be-AOR , 1pl.abs event.from-OBL-SUPER-EL agree remain-AOR .
well Chukotka-ERG cold place-Q be-AOP was , very cold was .	well Chukotka cold place was , cold place was .
( Natavan )	( Natavan ).
they-ERG « call.IMPV that boy » say-ENT , « they 2sg-DAT take.IMPV » say-ENT , « they he-DAT worthy cop.NEG ».	they-ERG « call.IMPV that boy » say-ENT , « they 2sg-DAT take.IMPV » say-ENT , « they he-DAT worthy cop.NEG ».
then this boy-ERG say-ENT that , « but now all happened-PERF », say-ENT , « grandfather-DIR-FOC punishment take-AOR , others-and-ERG-FOC punishment take-AOR , but ,» say-AOR , « other-one province-in-INESS 1sg.gen mother-FOC still.be,.remain » say-AOR , « three brother-FOC still.be,.remain , two brother-FOC still.be,.remain » say-AOR .	then this boy-ERG say-ENT that , « but now all happened-PERF », say-ENT , « grandfather-DIR-FOC punishment take-AOR , others.and-ERG-FOC punishment take-AOR , but ,» say-AOR , « other.one province.in-INESS 1sg.gen mother-FOC still.be,.remain » say-AOR , « three brother-FOC still.be,.remain , two brother-FOC still.be,.remain » say-AOR .
« this pouring-out-AOC-AOR that,.the.same king-DIR-GEN over-SPSS-INELAT say.IMP that » say-ENT , « 2sg-SBSS-EL or dog be-AOP , or pig be-AOP ».	« this pouring.AOC-AOR that,.the.same king-DIR-GEN over-SPSS-INELAT say.IMP that » say-ENT , « 2sg-SBSS-EL or dog be.will-AOP , or pig be.will-AOP ».
again go-AOR yard.in-INESS-DAT .	more-FOC go-AOR himself yard.in-INESS-SPSS .
they.and-ERG-FOC punishment order.IMPV » say-AOR .	they.to.also punishment order.IMPV » say-AOR .
eight three soldier-PL-EL from nation-PL is-AOP was , Russian-PL-ERG-GEN many nation is-AOP .	Twenty three soldier-ERG-SBSS-EL eight nation is-AOP 1pl.abs , russians.also-FOC very was , eight nation is-PST .
« sea-OBL-GEN want-ERG-DAT come let.us-IMPV 1sg.abs sea-OBL-GEN steed-POESS with fight-AOP-COND 1sg.ERG-DAT kill-AOR-SUB want-IMPF » say-ENT .	« sea-OBL-GEN want-ERG-DAT a.going.MSD for-INELAT-FOC 1sg.abs sea-OBL-GEN steed-ERG-POESS with-DAT fight.AOC want-IMPF » say-ENT .
and oldest self-GEN say-AOR : dear self , say-AOR , 2sg.gen horse never , say-AOR .	this elder sister-ERG small-OBL-DAT say-AOR : dear sister , say-AOR , 2sg.gen horse never , say-AOR .
table-PL-OBL-DAT put.on.the.ground-IMPF tablecloth-PL-OBL-DAT , all village-ERG-GEN child-PL-ABS go-IMPF-PST there .	chairs.on-PL open-PST-ENT-PST ground.in-INESS-SPSS , tablecloths-PL-FOC , all village-ERG-GEN child-PL go-ENT-AOP .
go-PST-1PL this bear-ACC but find-IMPF-NEG 1PL	turns 1pl.abs this bear-OBL-POESS , find-MSD not.make.PRF.PTP-AOP 1pl.gen-DAT .
1pl.gen love-POSS one was , love-POSS one was .	our love-FOC one was , love-FOC one was .
« AT.THAT.TIME », say-ENT , « one people-OBL-DAT chase.out-AOR », say-ENT , « 2sg.abs king choose-PASS-ENT », say-ENT .	AT.THAT.TIME-INESS », say-ENT , « it will.chase.FUT-ENT public-ERG », say-ENT , « 2sg.abs king choose.IMP-INESS » say-ENT .
1sg.abs go-AOR Derbent-DIR-DAT	1sg.abs go-PERF-PTP Derbent.in-OBL-DAT
« cut.IMPV their head-PL » say-AOR .	« cut.IMPV their chapter-PL » say-AOR .
come come.out water-SPSS , Bezkhanum	come come.out-ERG water.on , Bezkhanum
« soil », say-AOR , « 1sg.ERG bring-AOR-AOR absolutely 2sg.gen eye-PL heal-AOC-PL-AOR want-INESS », say-AOR .	« soil-AD-PL », say-AOR , « 1sg.ERG brought.AOR-AOR absolutely 2sg.gen eye-PL heal.AOC-PL-AOR want-INESS », say-AOR .
after return-PERF 1pl.abs summer camp-DIR-DAT , to.rest-INF .	after return-PERF 1pl.abs summer camp-DIR-DAT , to.have.a.rest-INF .
see-PST-TEMP that , « Isabala brother , dog-PL-GEN child give.birth-AOR-AOR hear-AOR , dog return-IMP-ENT 1sg.DAT please.do »	Isabala seen-TEMP say-AOC that 1sg.ERG , « Isabala brother , puppy-PL-FOC be-AOR say-IMPF , give 1sg.gen dog .
why scale-POSS-GEN one plate-INESS-SPSS that person put-IMPF that , another plate-INESS-SPSS truth justice uprightness purity .	then justice scale-DIR-AD one side.on put.IMPV-PERF that,.the.same man , another side.on-FOC – truth , justice , right-PURP , today-PURP , cleanless-PURP .
he-and take.down-AOC girl deceive-AOC her house-OBL-DAT when.taking-TEMP this girl run-ENT his arm-from	he.and taking.down.AOC girl deceiving.AOC her house-OBL-DAT when.taking.TEMP this girl ran.ENT his arm.from .
knock-AOR 1pl.erg one door , apperance-AOR here-SPSS , kazakh is-AOP	run.IMP-AOR 1pl.erg one window-INESS , apperance-AOR here-SPSS , kazakh was
« call?-ERG », say-AOR , « this boy today-GEN-ERG-GEN day.from be-ENT king , 1sg.abs-FOC his wife .»	« call?-ERG », say-AOR , « this boy today-GEN-ERG-GEN day.from be-ENT king , 1sg.abs-FOC his wife .»
unfaithful , untrusted .	unfaithful , untrusted .
1SG.ABS-FOC ARMENIAN-DIR-POESS ON.THE.CONTRARY	1sg.abs-FOC armenian-DIR-POESS on.the.contrary
AT.THIS.TIME third boy-ERG say-AOR : « dear father », say-AOR , « now 1sg.ERG will.bring-ENT », say-AOR .	AT.THIS.TIME-INESS THIRD-PST boy-ERG say-AOR : « dear father », say-AOR , « now 1sg.ERG will.bring-INESS », say-AOR .
but , say-AOC , two time-INESS come-AOR , say-AOR , give-AOC one statement mother-OBL-DAT side.on you.know 1pl.erg	but , say-AOC , come-ENT-PST time-INESS , say-AOC , come , say-AOR , mother-DIR-DAT one statement to.give you.know 1pl.erg .
snow-PL-INESS heavy be-AOP , snow	snow-INESS-DIR-GEN small flake you.know , flake
2sg.gen heart-OBL-SPSS remember-IMPV-2sgQ	2sg.gen heart-ERG-SPSS still.remember-Q ?)
well , history-ERG-GEN this evidence-PL say-AOR-ENT , history-ERG exactly-ABL , 2sg.gen you.know — Uhm , Uhm , time tell-AOP-NEG can-NEG , time-PL show-AOP-NEG can-NEG .	well , history-OBL-GEN this evidence-PL say-PST-TEMP , history-OBL-GEN FROM.EXACTLY , they you.know — Uhm , Uhm , time 1sg.ERG-AD-EL say-INF be-FUT-NEG , time-PL show be-FUT-NEG 1sg.ERG-AD-EL 2pl.dat-DAT .
1sg.abs a Soviet-ERG-DAT-FOC take-AOR party-DAT-FOC accept-AOR , 1sg.ERG-DAT give-AOR ten day-PL , all-INESS-SPSS happened-AOR .	1sg.abs that soviets' time-DIR-DAT party-DIR-DAT take.over , 1sg.ERG-DAT vacation give-AOR ten 24.hour.period , such-PL be-AOR .
but , say-AOC , one water.pipe-ERG-DAT go-MSD-AOR that .	but , say-AOC , one down dam-INESS-SPSS go-MSD 1pl.abs .
today 1pl.erg 1sg.abs 1sg.abs head.on swear.word	that-ERG-SPSS 1pl.erg , 1sg.abs , 1sg.abs in.the be ...
then on 1pl.gen that return-AOR , captain .	then on 1pl.gen that return-AOR , captain .
"« ""Samur"" » newspaper-OBL-GEN fireplace-INESS fire still.be,.remain-PRF"	"« ""Samur"" » newspaper-OBL-GEN fireplace-INESS today-FOC fire cop-IMPF ."
finish happened-AOR ... that mortar-man be-AOP was , three we-ERG-GEN man	finish happened-AOR ... there-SPSS 1pl.abs mortar.men was , mine-PL threw.ENT-ENT-PST three person
They.and he put-ENT that-on and her throne-on seat-ENT .	They.and he put.ENT that.on and her throne.on seat.ENT .
die-IMPV he	die-IMP still.be,.remain !
call.IMPV this boatman-DIR-PL-DAT say-ENT that , « hey brother , 1pl.abs » say-ENT « sea-OBL-GEN other.side-INESS boat-ERG-DAT bank-DIR-PL-ACC take.IMPV-AOR want-FUT 2sg.abs-ERG-DAT ».	called.ENT this boatman-DIR-DAT say-ENT that , « dear brother , 1pl.abs » say-ENT « sea-OBL-GEN other bank-ERG-DAT get.out-AOR want-ENT 2sg.abs-ERG ».
soul Bezkhanum , soul Bezkhanum	soul Bezkhanum , soul Bezkhanum
to.gather-AOR man-PL call-IMPV-ENT all .	to.gather-AOR man-PL call.IMPV-ENT all .
this by guided be-is-3SG.F	what.for for took ?
AT.THIS.TIME third boy-ERG say-AOR : « dear father », say-AOR , « now 1sg.ERG will.bring-ENT », say-AOR .	AT.THIS.TIME-INESS THIRD-PST boy-ERG say-AOR : « dear father », say-AOR , « now 1sg.ERG will.bring-INESS », say-AOR .
1SG.ABS-FOC BREAD EAT-AOC , 1PL.ERG THREE-ERG , 1SG.ABS-FOC WATER-SPSS GO-AOR .	1sg.abs-FOC bread ate-AOC , 1pl.erg three-ERG , 1sg.abs-FOC water-SPSS go-AOR .
« very 2sg.abs think-DIR-DAT go-PERF that ».	« very 2sg.abs attention-DIR-DAT go-PERF that ».
my mother teacher was , my father accountant was .	my mother teacher was , my grandfather-AND accountant was .
then return-AOR free-ABS be-PRS , home-DAT	then return-AOR free , thing-OBL-GEN , family-OBL-DAT
one escape-IMPF .	one escape-IMPF .
mind-from-SBST-SPSS-AOP agree isn't , 1sg.abs know.how cop.neg , say-IMPF .	decision-DIR-SPSS-EL 1sg.abs separated isn't , say-IMPF .
that day-OBL-SUPER-EL after 1sg.ERG-DAT early-ADV sergeant rank give-AOR .	there-SPSS-EL after 1sg.ERG-DAT earlier rank sergeant give-AOR .
like.that happened-AOP-TEMP ashuq-DIR what say-IMPF	like.that happened-AOP-TEMP love-DIR what say-IMPF ?
go-ENT 1sg.abs shepherd-PL-DIR yard.in-INESS-SPSS	go-ENT 1sg.abs shepherd-DIR-GEN yard.in-INESS-SPSS .
no , sea-OBL on blood apperance NEG-make-PTP-COND , 1SG.ABS exist-NEG », say-INESS .	no , sea-OBL-GEN on blood apperance NEG.make.PTP-COND , 1sg.abs exist.doesn't », say-INESS .
coming-PST-TEMP , « oh boy », say-ENT , « 1sg.ERG-DAT voice coming-AOR , say-AOR , 2sg.gen house-INESS pearls-PL cop » say-AOR .	coming-PST-TEMP , « oh boy », say-ENT , « 1sg.ERG-DAT voice coming-AOR , say-AOR , 2sg.gen house-INESS pearls-PL cop » say-AOR .
there-PST after go-AOR 1pl.abs Chukotka-DIR-DAT .	there.from after to.go-HORT 1pl.abs Chukotka-ERG-DAT .
and God-ERG-POSS other-PL-ABS bless-IMPF-3SG	he-AOP people-DIR-SPSS-INELAT Allah agree let.it.be.OPT .
this time , 1sg.abs 1pl.gen each.other-DAT offend-IMPF-PST be-AOP-SBST happened-AOR .	2sg.abs 1sg.ERG-SBSS-EL , 1sg.abs 2sg-SBSS-EL worry was time-PL-Q be-AOR .
there .	there .
that time-DAT generally disaster was .	that times commonly disaster was .
until us-ERG-DAT let.us.out-AOR , 1pl.erg tea-OBL-DAT let.us.out-AOR boy-OBL .	this let.us.out so.much , 1pl.erg water let.us.out so.much time-OBL-SPSS .
these-ERG take-ENT this picture put.IMPV-ENT spring-INESS-SPSS .	these-ERG-Q take-ENT this picture put.IMPV-ENT spring-INESS-SPSS .
that,.the.same two-ERG-Q say-AOR , one see-AOR that-SBSS-INELAT young.man-ABS-Q 1sg.ERG-DAT face resemble-AOP one.little our .	that,.the.same like.this , one boy look-AOC 1sg.ERG-DAT ours similar was face-INELAT one A.LITTLE .
guy-ERG-and think-ENT , « I-wonder » say-ENT « 1sg-abs go-PTP-COND before girl here put-AOC if-do grandfather-DIR come-AOR girl steal-INF do-again-ENT-INESS .	guy.ERG.and attention-ENT , « I.wonder » say-ENT « 1sg.abs going.PTP.COND before girl here puting.AOC if.do grandfather-DIR coming-AOR girl steal.INF did.again.ENT-INESS .
after.all very think-MSD-off after girl board-AOC boat-INESS , send-ENT this girl boat-in.being.IMC other side	after.all very a.thinking.MSD.off after girl boarding.AOC boat-INESS , sent.ENT this girl boat.in.being.IMC other side .
they-ERG this boatman-DIR-DAT call.AOR-AOR say-ENT that , « hey brother , 1pl.abs » say-ENT « sea-OBL-GEN bank-ACC-DIR-DAT take.out-AOC want-FUT 2sg.abs 1pl.ERG-DAT ».	called.ENT this boatman-DIR-DAT say-ENT that , « dear brother , 1pl.abs » say-ENT « sea-OBL-GEN other bank-ERG-DAT get.out-AOR want-ENT 2sg.abs-ERG ».
1PL.ABS TWO ESCAPE-AOR .	1pl.abs two escaped-AOR .
04 : 49	04 : 19
« AT.THAT.TIME-INESS-FOC », say-ENT , « one people-OBL-DAT appear.AOR », say-ENT , « 2sg.abs king choose.IMP » say-ENT .	AT.THAT.TIME-INESS », say-ENT , « it will.chase.FUT-ENT public-ERG », say-ENT , « 2sg.abs king choose.IMP-INESS » say-ENT .
battalion-OBL-GEN land surveyor be-AOP was 1sg.abs	battalion's-DIR-GEN land.surviver was 1sg.abs
May-INESS engage-AOR 1pl.abs , September-INESS go-AOR 1pl.abs married be-AOC .	May-OBL-DAT engagament be-AOR , sentyabr-OBL-DAT 1pl.abs married be-AOR .
« this way NEG work-AOR », say-ENT .	« like.that will.not.be that », say-ENT .
he-ERG this-DAT new love song-ACC Bezkhanum-DAT write-AOR :	love-PL-ERG-DAT her-GEN new chapter-EL song-PL created-AOR Bezkhanum-ERG-DAT :
happened-AOR friend-PL very good be-AOR , kind be-AOR	brother-PL-OBL-POESS with kind happened-AOC , good happened-AOR .
1SG.ABS , SAY-AOR , HELP DO , 1SG.ABS TAKE.BACK , SAY-AOR , HERE-ERG LEAVE-PROH , SAY-AOR .	1sg.abs , say-AOR , help do , 1sg.abs take.back , say-AOR , here-ERG leave-PROH , say-AOR .
HIMSELF-ERG-GEN SON WAY-ERG-DAT WANT BE.FUT.Q	himself-ERG-GEN son way-ERG-DAT want be.FUT.Q ?
but , say-IMPF , Bezkhanum , say-IMPF , world-OBL-INESS in one side be-FUT-COND , ashuq-ERG-DAT 2sg.abs-ERG word give-AOC want-FUT .	but , say-IMPF , Bezkhanum , say-IMPF , world.on-INESS all one side if.is , ashuq-DIR-DAT 2sg.abs-ERG word give-AOR want-FUT .
« dear old-woman grandmother » say-ENT , « 2sg-DAT girl want-ENT-FOC », say-ENT , « 2sg-DAT one baby want-ENT-FOC », say-ENT ?	« dear old.woman grandmother » say-ENT , « 2sg-DAT girl want-ENT-FOC », say-ENT , « 2sg-DAT one baby want-ENT-FOC », say-ENT ?
release.IMMANT-IMC FLEW-AOR coming-AOR this bird sitting.down.AOC-ENT girl-ERG-GEN shoulder-INESS-SPSS .	release.IMMANT-IMC FLEW-AOR coming-AOR this bird sitting.down.AOC-ENT girl-ERG-GEN shoulder-INESS-SPSS .
« now-INESS bring.IMPV.Q-FOC 2sg.ERG 1sg.DAT », say-ENT , « 1sg.ERG-POESS touch.not.PROHIB-PROH only ».	« now-INESS bring.IMPV.Q-FOC 1sg.ERG 2sg-DAT », say-ENT , « 1sg.ERG-POESS touch.not.PROHIB-PROH only ».
1PL-ABS there return-AOR one this village-ERG-DAT	1pl.abs return-AOR this one there village-ERG-DAT
horse-ERG say-ENT : « what happened-PERF », say-ENT , « more-FOC head down-AOR that », say-ENT , « what happened-PERF , what think-PL-IMPF ?»	horse-ERG say-ENT : « what happened-PERF », say-ENT , « more-FOC head hang.AOC-AOR that », say-ENT , « what happened-PERF , what attention-PL-IMPF ?»
