predicted_glosses	glosses
« 1SG.ABS », say-AOR , « go-AOR man-ERG-GEN between-INESS enter-FUT-FUT , look-HORT maybe 1SG.GEN fate-INESS cop . »	« 1sg.abs », say-AOR , « go-AOR man-ERG-GEN between-INESS enter.FUT-FUT , look.HORT maybe 1sg.gen fate-INESS cop .»
decision one was .	agreement-PL one was .
« And.but 1pl.abs them-ERG-GEN to return-INF want-ENT , come group be-AOR go.back.HORT 1pl.abs .»	« And.but 1pl.abs them-ERG-GEN to returned-AOR want-ENT , come group happened-AOR go.back.HORT 1pl.abs .»
what cop-Q hey ashuq boy	love what was , ashuq boy ?
what-ERG , where be-AOR ?	what-DAT , where be-AOR ?
good many say-AOR , happened-AOR , 1pl.abs event-ERG-ABL all happy be-AOR .	good toasts-PL say-AOR , agreements-PL be-AOR , 1pl.abs event.from-OBL-SUPER-EL agree remain-AOR .
well Chukotka cold be-PST-PTP place , very cold was .	well Chukotka cold place was , cold place was .
( Natavan )	( Natavan ).
they-ERG « call.IMPV that boy » say-ENT , « they 2sg-DAT take.IMPV » say-ENT , « they he-DAT worthy cop.NEG ».	they-ERG « call.IMPV that boy » say-ENT , « they 2sg-DAT take.IMPV » say-ENT , « they he-DAT worthy cop.NEG ».
then this boy-ERG say-ENT that , « but now all happened-PERF », say-ENT , « grandfather-DIR-FOC punishment take-AOR , others.and-ERG-FOC punishment take-AOR , but ,» say-AOR , « other.one province.in-INESS 1sg.gen mother-FOC still.be,.remain » say-AOR , « three brother-FOC still.be,.remain , two brother-FOC still.be,.remain » say-AOR .	then this boy-ERG say-ENT that , « but now all happened-PERF », say-ENT , « grandfather-DIR-FOC punishment take-AOR , others.and-ERG-FOC punishment take-AOR , but ,» say-AOR , « other.one province.in-INESS 1sg.gen mother-FOC still.be,.remain » say-AOR , « three brother-FOC still.be,.remain , two brother-FOC still.be,.remain » say-AOR .
« this pouring-out-AOC-AOR that,.the.same king-DIR-GEN over-SPSS-INELAT say.IMP that » say-ENT , « 2sg-SBSS-EL or dog be.FUT-AOP , or pig be.FUT-AOP ».	« this pouring.AOC-AOR that,.the.same king-DIR-GEN over-SPSS-INELAT say.IMP that » say-ENT , « 2sg-SBSS-EL or dog be.will-AOP , or pig be.will-AOP ».
more-FOC go-AOR again yard.in-INESS-SPSS .	more-FOC go-AOR himself yard.in-INESS-SPSS .
they.and punishment order.IMPV » say-AOR .	they.to.also punishment order.IMPV » say-AOR .
twenty three soldier-PL-OBL-GEN eight nation is-AOP was , Russian-PL-OBL many nation is-AOP was .	Twenty three soldier-ERG-SBSS-EL eight nation is-AOP 1pl.abs , russians.also-FOC very was , eight nation is-PST .
« sea-OBL-GEN want-ERG-DAT now go-AOR-COND 1sg.abs sea-OBL-GEN steed-POESS with fight-AOR-COND must », say-ENT .	« sea-OBL-GEN want-ERG-DAT a.going.MSD for-INELAT-FOC 1sg.abs sea-OBL-GEN steed-ERG-POESS with-DAT fight.AOC want-IMPF » say-ENT .
this oldest sister-ERG say-AOR : dear sister-VOC , 1sg.ERG-DAT , one horse never , say-AOR .	this elder sister-ERG small-OBL-DAT say-AOR : dear sister , say-AOR , 2sg.gen horse never , say-AOR .
table-PL-OBL-POSS on.ground spread-AOR , tablecloth-PL-OBL-GEN , all village-ERG-GEN child-PL go-IMPF-CONV .	chairs.on-PL open-PST-ENT-PST ground.in-INESS-SPSS , tablecloths-PL-FOC , all village-ERG-GEN child-PL go-ENT-AOP .
look.for-AOR-PTP 1pl.abs this bear-SPSS but find-IMPF-NEG 1pl.abs .	turns 1pl.abs this bear-OBL-POESS , find-MSD not.make.PRF.PTP-AOP 1pl.gen-DAT .
1pl.gen ashuq-PL-ERG-DAT one was , love-ERG-DAT one was .	our love-FOC one was , love-FOC one was .
« AT.THAT.TIME », say-ENT, « 1pl.abs people-INESS chase-FUT-ENT », say-ENT, « 2sg.abs king choose-FUT-ENT » say-ENT.	AT.THAT.TIME-INESS », say-ENT , « it will.chase.FUT-ENT public-ERG », say-ENT , « 2sg.abs king choose.IMP-INESS » say-ENT .
1sg.abs go-PERF-PTP Derbent-DAT	1sg.abs go-PERF-PTP Derbent.in-OBL-DAT
« cut.off-IMPV their head-PL » say-AOR .	« cut.IMPV their chapter-PL » say-AOR .
come come.out water-SPSS , Bezkhanum	come come.out-ERG water.on , Bezkhanum
« soil », say-AOR , « 1sg.ERG bring-AOR-AOR absolutely 2sg.gen eye-PL heal-AOC-PL-AOR want-INESS », say-AOR .	« soil-AD-PL », say-AOR , « 1sg.ERG brought.AOR-AOR absolutely 2sg.gen eye-PL heal.AOC-PL-AOR want-INESS », say-AOR .
after return-PERF 1pl.abs summer camp-DIR-DAT to.rest-INF .	after return-PERF 1pl.abs summer camp-DIR-DAT , to.have.a.rest-INF .
when Isabala see-PST-TEMP say-AOC that , « Isabala brother , dog-DIM-PL-OBL child hear-IMPF-PST say-AOR , return-IMP-ENT 2sg.abs dog please.do 1sg.DAT »	Isabala seen-TEMP say-AOC that 1sg.ERG , « Isabala brother , puppy-PL-FOC be-AOR say-IMPF , give 1sg.gen dog .
that plate-OBL-POSS one on put-IMPF that,.the.same person-OBL-ACC , another plate-OBL-POSS – that,.the.same truth-NOM , justice-NOM , uprightness-NOM , purity-NOM , honesty-NOM .	then justice scale-DIR-AD one side.on put.IMPV-PERF that,.the.same man , another side.on-FOC – truth , justice , right-PURP , today-PURP , cleanless-PURP .
he-ERG-and taking-down-AOC girl deceiving-AOC her house-OBL-DAT when-taking-TEMP this girl ran-ENT his arm-from	he.and taking.down.AOC girl deceiving.AOC her house-OBL-DAT when.taking.TEMP this girl ran.ENT his arm.from .
knock-AOR 1pl.erg one door-ACC , apperance-AOR here-SPSS , kazakh be-AOP was	run.IMP-AOR 1pl.erg one window-INESS , apperance-AOR here-SPSS , kazakh was
« call-IMP-ERG », say-AOR , « this boy today-GEN-ERG-GEN day.from be-FUT king , 1sg.abs-FOC his wife .»	« call?-ERG », say-AOR , « this boy today-GEN-ERG-GEN day.from be-ENT king , 1sg.abs-FOC his wife .»
unfaithful , untrusted .	unfaithful , untrusted .
1SG.ABS-FOC ARMENIAN-DIR-POSS ON.THE.CONTRARY	1sg.abs-FOC armenian-DIR-POESS on.the.contrary
AT.THIS.TIME three-ORDINAL boy-ERG say-AOR : « dear father », say-AOR , « now 1sg.ERG will.bring-ENT », say-AOR .	AT.THIS.TIME-INESS THIRD-PST boy-ERG say-AOR : « dear father », say-AOR , « now 1sg.ERG will.bring-INESS », say-AOR .
but , say-AOC , two time after , say-AOC , come , say-AOC , mother-OBL-DAT one petition give you.know 1pl.erg-DAT .	but , say-AOC , come-ENT-PST time-INESS , say-AOC , come , say-AOR , mother-DIR-DAT one statement to.give you.know 1pl.erg .
heavy snowflake-PL-INESS be-AOR , snowflake-PL-INESS	snow-INESS-DIR-GEN small flake you.know , flake
2sg.gen heart-OBL-SPSS remember-Q	2sg.gen heart-ERG-SPSS still.remember-Q ?)
well , history-GEN this evidence-PL say-IMPF that , history-GEN exactly-INESS , obl.stm-ABS you.know — uhm , uhm , time tell-IMPF-NEG 1sg.ERG-DAT , show be-IMPF-NEG 1sg.ERG time-PL-ACC .	well , history-OBL-GEN this evidence-PL say-PST-TEMP , history-OBL-GEN FROM.EXACTLY , they you.know — Uhm , Uhm , time 1sg.ERG-AD-EL say-INF be-FUT-NEG , time-PL show be-FUT-NEG 1sg.ERG-AD-EL 2pl.dat-DAT .
1sg.abs-DAT Soviet-ERG-GEN time-INESS party-DAT accept-AOR , 1sg.ERG-DAT vacation give-AOR ten day , all-PL happened-AOR .	1sg.abs that soviets' time-DIR-DAT party-DIR-DAT take.over , 1sg.ERG-DAT vacation give-AOR ten 24.hour.period , such-PL be-AOR .
but , say-AOR , one dam-INESS go-MSD decided-AOR that .	but , say-AOC , one down dam-INESS-SPSS go-MSD 1pl.abs .
that-OBL-SPSS 1pl.erg 1sg.abs 1sg.abs head-on die-NEG ...	that-ERG-SPSS 1pl.erg , 1sg.abs , 1sg.abs in.the be ...
then on 1pl.gen that return-AOR , captain .	then on 1pl.gen that return-AOR , captain .
"« ""Samur"" » newspaper-OBL-GEN fireplace-OBL-INESS fire cop-IMPF"	"« ""Samur"" » newspaper-OBL-GEN fireplace-INESS today-FOC fire cop-IMPF ."
finish happened-AOR ... go-AOR 1pl.abs mortar.man be-PTP , there be-PST one three man	finish happened-AOR ... there-SPSS 1pl.abs mortar.men was , mine-PL threw.ENT-ENT-PST three person
They-ERG-Q and he put-ENT that-on and her throne-on seat-ENT .	They.and he put.ENT that.on and her throne.on seat.ENT .
die he-NEG !	die-IMP still.be,.remain !
call.IMPV this boatman-ERG-FOC say-ENT that , « was brother , 1pl.abs » say-ENT « sea-OBL-GEN other.side-INESS-SPSS bank-ERG-DAT take.out-AOC want-FUT 2sg.abs-ERG-DAT 1pl.abs ».	called.ENT this boatman-DIR-DAT say-ENT that , « dear brother , 1pl.abs » say-ENT « sea-OBL-GEN other bank-ERG-DAT get.out-AOR want-ENT 2sg.abs-ERG ».
soul Bezkhanum , soul Bezkhanum	soul Bezkhanum , soul Bezkhanum
to.gather-AOR man-PL call.IMPV-ENT all .	to.gather-AOR man-PL call.IMPV-ENT all .
it-ABS by guided-be-3SG-FOC ?	what.for for took ?
AT.THIS.TIME three-ORD boy-ERG say-AOR : « dear father », say-AOR , « now 1sg.ERG will.bring-ENT », say-AOR .	AT.THIS.TIME-INESS THIRD-PST boy-ERG say-AOR : « dear father », say-AOR , « now 1sg.ERG will.bring-INESS », say-AOR .
1SG.ABS-FOC BREAD EAT-AOC , 1PL.ERG THREE-ERG , 1SG.ABS-FOC WATER-SPSS GO-AOR .	1sg.abs-FOC bread ate-AOC , 1pl.erg three-ERG , 1sg.abs-FOC water-SPSS go-AOR .
« very 2sg.abs think-DIR-DAT go-PERF that ».	« very 2sg.abs attention-DIR-DAT go-PERF that ».
my mother teacher was , my father accountant was .	my mother teacher was , my grandfather-AND accountant was .
then return-AOR free-MSD , finally , family-DIR-DAT	then return-AOR free , thing-OBL-GEN , family-OBL-DAT
one run-IMPF	one escape-IMPF .
NEG.change-IMPF-AOP-SBST-PST 1sg.abs mind cop-NEG , say-IMPF .	decision-DIR-SPSS-EL 1sg.abs separated isn't , say-IMPF .
after-AOP 1sg.ERG-DAT early-ADV sergeant rank give-AOR .	there-SPSS-EL after 1sg.ERG-DAT earlier rank sergeant give-AOR .
like.that happened-AOP-TEMP ashuq what say-IMPF ?	like.that happened-AOP-TEMP love-DIR what say-IMPF ?
go-ENT 1sg.abs shepherd-DIR-GEN yard.in-INESS-SPSS	go-ENT 1sg.abs shepherd-DIR-GEN yard.in-INESS-SPSS .
no , sea-OBL-GEN on blood apperance NEG.make.PTP-COND , 1sg.abs exist.NEG », say-INESS .	no , sea-OBL-GEN on blood apperance NEG.make.PTP-COND , 1sg.abs exist.doesn't », say-INESS .
coming-PST-TEMP , « oh boy », say-ENT , « 1sg.ERG-DAT voice coming-AOR , say-AOR , 2sg.GEN house-INESS pearls-PL cop » say-AOR .	coming-PST-TEMP , « oh boy », say-ENT , « 1sg.ERG-DAT voice coming-AOR , say-AOR , 2sg.gen house-INESS pearls-PL cop » say-AOR .
there-PST after 1pl.abs go-AOR Chukotka-DIR-DAT .	there.from after to.go-HORT 1pl.abs Chukotka-ERG-DAT .
we.INCL community-DIR-SPSS-EL God agree be-IMPF-SBJV-3PL-DAT .	he-AOP people-DIR-SPSS-INELAT Allah agree let.it.be.OPT .
2sg.abs this-DAT , 1sg.abs 2sg.abs-DAT offend-IMPF-PST be-IMPF-PTP be-AOR .	2sg.abs 1sg.ERG-SBSS-EL , 1sg.abs 2sg-SBSS-EL worry was time-PL-Q be-AOR .
there .	there .
that in.the.past awesome was .	that times commonly disaster was .
until put-AOR-IMPF 1pl.erg this-ABS water-INESS , 1pl.erg boy-ABS .	this let.us.out so.much , 1pl.erg water let.us.out so.much time-OBL-SPSS .
these-ERG-Q take-ENT this picture put.IMPV-ENT spring-INESS-SPSS .	these-ERG-Q take-ENT this picture put.IMPV-ENT spring-INESS-SPSS .
that,.the.same and that , one this boy-ERG-DAT 1sg.ERG-DAT face resemble-AOP-SBST one little 1pl.gen-like .	that,.the.same like.this , one boy look-AOC 1sg.ERG-DAT ours similar was face-INELAT one A.LITTLE .
boy-DIR-GEN-ERG and attention-ENT , « I.wonder » say-ENT « 1SG-ABS go-PTCP-COND before girl here put-AOR if-DO grandfather-DIR come-AOR girl steal-INF do-HAB-PAST-3SG .	guy.ERG.and attention-ENT , « I.wonder » say-ENT « 1sg.abs going.PTP.COND before girl here puting.AOC if.do grandfather-DIR coming-AOR girl steal.INF did.again.ENT-INESS .
after.all very think-MSD-off after girl boarding AOC boat-INESS , send-ENT this girl boat-in-being-IMC other side	after.all very a.thinking.MSD.off after girl boarding.AOC boat-INESS , sent.ENT this girl boat.in.being.IMC other side .
call.IMPF this boatman-DIR-PL-ERG and ask.IMPF that , « brother , 1pl.abs » say-ENT « sea-OBL-GEN other.side-INESS-SPSS-EL bank-ERG-DAT take-AOC-AOR want-FUT 2sg.abs ».	called.ENT this boatman-DIR-DAT say-ENT that , « dear brother , 1pl.abs » say-ENT « sea-OBL-GEN other bank-ERG-DAT get.out-AOR want-ENT 2sg.abs-ERG ».
1PL.ABS TWO ESCAPE-AOR .	1pl.abs two escaped-AOR .
04 : 49	04 : 19
« AT.THAT.TIME-INESS » say-ENT , « that people-OBL-DAT chase.out-FUT-ENT », say-ENT , « 2sg.abs king choose.FUT-ENT » say-ENT .	AT.THAT.TIME-INESS », say-ENT , « it will.chase.FUT-ENT public-ERG », say-ENT , « 2sg.abs king choose.IMP-INESS » say-ENT .
battalion-OBL-GEN land.surveyor be-PTP was 1sg.abs	battalion's-DIR-GEN land.surviver was 1sg.abs
May-INESS happened-AOR , September-INESS 1pl.abs married be-AOR .	May-OBL-DAT engagament be-AOR , sentyabr-OBL-DAT 1pl.abs married be-AOR .
« NEG.be.AOP », say-ENT .	« like.that will.not.be that », say-ENT .
he-ERG her-DAT new love-song write-AOR Bezkhanum-DAT :	love-PL-ERG-DAT her-GEN new chapter-EL song-PL created-AOR Bezkhanum-ERG-DAT :
old-ERG-POESS with friendship-AOR be-AOR good be-AOR	brother-PL-OBL-POESS with kind happened-AOC , good happened-AOR .
1SG.ABS , SAY-AOR , HELP DO , 1SG.ABS TAKE.BACK , SAY-AOR , HERE-ERG LEAVE-PROH , SAY-AOR .	1sg.abs , say-AOR , help do , 1sg.abs take.back , say-AOR , here-ERG leave-PROH , say-AOR .
himself-ERG-GEN son way-ERG-DAT want be.FUT.Q ?	himself-ERG-GEN son way-ERG-DAT want be.FUT.Q ?
but , say-IMPF , Bezkhanum , say-IMPF , world-INESS one against be-COND , ashuq-DIR-DAT 2sg.abs word give-AOC 1sg.ERG-DAT want-FUT .	but , say-IMPF , Bezkhanum , say-IMPF , world.on-INESS all one side if.is , ashuq-DIR-DAT 2sg.abs-ERG word give-AOR want-FUT .
« dear old-woman grandmother » say-ENT , « 2sg-DAT girl want-ENT-FOC », say-ENT , « 2sg-DAT one baby want-ENT-FOC », say-ENT ?	« dear old.woman grandmother » say-ENT , « 2sg-DAT girl want-ENT-FOC », say-ENT , « 2sg-DAT one baby want-ENT-FOC », say-ENT ?
release.IMMANT-IMC FLEW-AOR coming-AOR this bird sitting.down.AOC-ENT girl-ERG-GEN shoulder-INESS-SPSS .	release.IMMANT-IMC FLEW-AOR coming-AOR this bird sitting.down.AOC-ENT girl-ERG-GEN shoulder-INESS-SPSS .
« now-INESS bring.IMPV.Q-FOC 1sg.ERG 2sg-DAT », say-ENT , « 1sg.ERG-POESS touch.not.PROHIB-PROH only ».	« now-INESS bring.IMPV.Q-FOC 1sg.ERG 2sg-DAT », say-ENT , « 1sg.ERG-POESS touch.not.PROHIB-PROH only ».
1PL.ABS-FOC return-AOR one village is-PST there	1pl.abs return-AOR this one there village-ERG-DAT
horse-ERG say-ENT : « what happened-PERF », say-ENT , « head-DIR down again be-AOR that », say-ENT , « what happened-PERF , what think-PL-IMPF ?»	horse-ERG say-ENT : « what happened-PERF », say-ENT , « more-FOC head hang.AOC-AOR that », say-ENT , « what happened-PERF , what attention-PL-IMPF ?»
